AAAGTCCGTCCACTTC-1_pos	malignant_0
AACACACCACAGCCAC-1_pos	malignant_0
AAGTGAAAGGGACAGG-1_pos	malignant_0
ACAAGCTGTGCCCGTA-1_pos	malignant_0
ACACGCGGTGTGGTCC-1_pos	malignant_0
ACACTGAGTCGACTGC-1_pos	malignant_0
ACCAACAAGTTGCCTA-1_pos	malignant_0
AGAACAATCTGGACTA-1_pos	malignant_0
AGACAGGTCATTACTC-1_pos	malignant_0
AGCGCTGGTTAGTCGT-1_pos	malignant_0
AGCTCAATCACCGGTG-1_pos	malignant_0
AGGACGAGTTCGGTTA-1_pos	malignant_0
AGGCATTCACAACCGC-1_pos	malignant_0
ATAGAGAAGGTTATAG-1_pos	malignant_0
ATCACAGCAATCTCTT-1_pos	malignant_0
ATCGATGAGACCAAAT-1_pos	malignant_0
ATGCCTCTCCAACCGG-1_pos	malignant_0
ATTCAGGAGGACGCTA-1_pos	malignant_0
CAATTTCTCACTGGTA-1_pos	malignant_0
CACAGATGTGTTGACT-1_pos	malignant_0
CAGATTGGTGGGAGAG-1_pos	malignant_0
CAGCACGTCTCGTGAA-1_pos	malignant_0
CAGTGCGTCACTTATC-1_pos	malignant_0
CCACGTTGTATGATCC-1_pos	malignant_0
CCCTTAGTCATCCTAT-1_pos	malignant_0
CCGCAAGGTGGCATCC-1_pos	malignant_0
CCTCTCCCAAGGTTGG-1_pos	malignant_0
CGAGTGCCAAAGGTTA-1_pos	malignant_0
CGGGACTGTGACTATC-1_pos	malignant_0
CGGGCATCAGTACTAC-1_pos	malignant_0
CTATCTATCAGCGGAA-1_pos	malignant_0
CTCAACCGTAACCCTA-1_pos	malignant_0
CTCCCTCTCGTTCTGC-1_pos	malignant_0
CTGCAGGTCGCCAGAC-1_pos	malignant_0
CTGCATCTCCACTTCG-1_pos	malignant_0
GAACACTTCGCCGAAC-1_pos	malignant_0
GACATCACATGCTGCG-1_pos	malignant_0
GAGTCTATCGACATTG-1_pos	malignant_0
GATCATGTCCATGAGT-1_pos	malignant_0
GATTCGATCCGGGACT-1_pos	malignant_0
GCCGATGAGTGTAGAT-1_pos	malignant_0
GCGAGAAAGGCGTTGA-1_pos	malignant_0
GCGGAAACACTGGACC-1_pos	malignant_0
GGAACCCTCATTGTTC-1_pos	malignant_0
GGAGAACGTAATCAGA-1_pos	malignant_0
GGCACGTGTATCTCTT-1_pos	malignant_0
GGTGTTATCTGGTGGC-1_pos	malignant_0
GTAGAGGCACGTCATA-1_pos	malignant_0
GTAGGAGTCTGCTTAT-1_pos	malignant_0
GTCGAATGTGGGAGAG-1_pos	malignant_0
GTTACCCGTAAGTCAA-1_pos	malignant_0
TATCGCCCAGCGTTGC-1_pos	malignant_0
TATTCCACATCTTCGC-1_pos	malignant_0
TATTGGGGTCCAGAAG-1_pos	malignant_0
TCCCACAAGTTTCTTC-1_pos	malignant_0
TCCGGGAGTGCTCTCT-1_pos	malignant_0
TCCTCCCCACGGATCC-1_pos	malignant_0
TCGTAGAAGCGGTATG-1_pos	malignant_0
TGAGTCACACGCTTAA-1_pos	malignant_0
TGCAGATTCTAAACGC-1_pos	malignant_0
TGCGATAGTGTCTAAC-1_pos	malignant_0
TGCTGAACATCCTTGC-1_pos	malignant_0
TGGATGTAGATCCCAT-1_pos	malignant_0
TGGGAGAAGAATGTTG-1_pos	malignant_0
TGGGTTAAGGATTTGA-1_pos	malignant_0
TGTCAGACACGAAAGC-1_pos	malignant_0
TGTCCTGGTTCCGCAG-1_pos	malignant_0
TGTGAGTCACTTCAAG-1_pos	malignant_0
TGTTACTTCTTAGGAC-1_pos	malignant_0
TGTTGGACACCATATG-1_pos	malignant_0
TTACGTTGTAGTTAGA-1_pos	malignant_0
TTCCAATTCTAAGCGT-1_pos	malignant_0
TTCCGTGTCTGATGGT-1_pos	malignant_0
TTCTGTACAGCAGATG-1_pos	malignant_0
TTGGGTATCCTGTAAG-1_pos	malignant_0
TTTGATCAGAATCGAT-1_pos	malignant_0
AAACGCTAGGGAGGCA-1_pos	malignant_1
AAAGAACAGAATAACC-1_pos	malignant_1
AAAGGATGTTATCTGG-1_pos	malignant_1
AACAACCTCGTGTGAT-1_pos	malignant_1
AACAAGACAGTTCACA-1_pos	malignant_1
AACACACAGAGCATAT-1_pos	malignant_1
AACCACACAATTCTCT-1_pos	malignant_1
AACCATGTCAAAGGTA-1_pos	malignant_1
AACCTGAGTAGGAGGG-1_pos	malignant_1
AACCTTTGTCCACACG-1_pos	malignant_1
AACGGGAAGATGGCGT-1_pos	malignant_1
AACGGGAAGCACACAG-1_pos	malignant_1
AACGGGAAGCCACCGT-1_pos	malignant_1
AAGACTCCAATCGCAT-1_pos	malignant_1
AAGCGTTAGTGCAGCA-1_pos	malignant_1
AAGCGTTTCCGATGTA-1_pos	malignant_1
AAGTACCAGAGGGTCT-1_pos	malignant_1
AAGTACCAGCAACTCT-1_pos	malignant_1
AAGTCGTTCTATTCGT-1_pos	malignant_1
AAGTGAACAATTGCGT-1_pos	malignant_1
AATTTCCGTACCAGAG-1_pos	malignant_1
ACAAGCTTCGCGAAGA-1_pos	malignant_1
ACACCAACACCGGTCA-1_pos	malignant_1
ACACCAACAGGCCCTA-1_pos	malignant_1
ACACGCGCAACTCCAA-1_pos	malignant_1
ACAGAAAAGCGAGAAA-1_pos	malignant_1
ACAGCCGGTAGCTGAG-1_pos	malignant_1
ACATCCCCAACGACAG-1_pos	malignant_1
ACATCGAAGAGTGTGC-1_pos	malignant_1
ACATTTCGTCCGGACT-1_pos	malignant_1
ACCACAAAGCGCTGCT-1_pos	malignant_1
ACCACAACACAGTCAT-1_pos	malignant_1
ACCACAACACGTCGTG-1_pos	malignant_1
ACCCTCAGTTCGTAAC-1_pos	malignant_1
ACCCTTGAGTGCAGGT-1_pos	malignant_1
ACCTGAAGTCATCCGG-1_pos	malignant_1
ACGATGTGTCACTACA-1_pos	malignant_1
ACGCACGCACACCGAC-1_pos	malignant_1
ACGGAAGTCGAGAGCA-1_pos	malignant_1
ACGGTTAGTTAAGACA-1_pos	malignant_1
ACGTAACCACTAGGTT-1_pos	malignant_1
ACGTAACCAGATACCT-1_pos	malignant_1
ACTATTCAGCTAAATG-1_pos	malignant_1
ACTATTCTCACCACAA-1_pos	malignant_1
ACTCCCATCCCGTGTT-1_pos	malignant_1
ACTGCAACATCGTGGC-1_pos	malignant_1
ACTGTGAAGCTAGAAT-1_pos	malignant_1
ACTTCCGGTCGGTGAA-1_pos	malignant_1
AGAACCTGTATTGCCA-1_pos	malignant_1
AGAACCTGTTCAGGTT-1_pos	malignant_1
AGAAGCGCATGTTCGA-1_pos	malignant_1
AGAAGTAAGAGGATCC-1_pos	malignant_1
AGACACTTCACTGGGC-1_pos	malignant_1
AGACAGGGTCGCTTGG-1_pos	malignant_1
AGACTCAAGACGCCAA-1_pos	malignant_1
AGACTCACATCCTGTC-1_pos	malignant_1
AGATCGTAGCACTAAA-1_pos	malignant_1
AGCGATTCATCAACCA-1_pos	malignant_1
AGCGTATGTACTAGCT-1_pos	malignant_1
AGCTACAGTGATGTAA-1_pos	malignant_1
AGGATAATCATCCCGT-1_pos	malignant_1
AGGCCACAGGGCTTCC-1_pos	malignant_1
AGGCCACCATCCGAGC-1_pos	malignant_1
AGGCTGCCAAGGGTCA-1_pos	malignant_1
AGGCTGCGTCGTGATT-1_pos	malignant_1
AGGGCCTCATGTGGTT-1_pos	malignant_1
AGGGTTTCACTACTTT-1_pos	malignant_1
AGTAGCTTCAAGTAAG-1_pos	malignant_1
AGTCAACCAAGATTGA-1_pos	malignant_1
AGTCACAGTTGTAGCT-1_pos	malignant_1
AGTCACATCTTTGGAG-1_pos	malignant_1
AGTCATGCATTCATCT-1_pos	malignant_1
AGTCATGTCTGCTTTA-1_pos	malignant_1
AGTCTCCCAACATCGT-1_pos	malignant_1
AGTGCCGTCATGAGTC-1_pos	malignant_1
AGTTCCCCAGACAAAT-1_pos	malignant_1
AGTTCGACAGTTCTAG-1_pos	malignant_1
ATACCGAGTTACCCAA-1_pos	malignant_1
ATACCTTTCTTCCAGC-1_pos	malignant_1
ATAGGCTTCAGTCACA-1_pos	malignant_1
ATAGGCTTCATGAAAG-1_pos	malignant_1
ATCACAGCATAATCGC-1_pos	malignant_1
ATCAGGTTCATTTACC-1_pos	malignant_1
ATCATTCAGAGCAGCT-1_pos	malignant_1
ATCCACCTCCATTTGT-1_pos	malignant_1
ATCCGTCAGCATATGA-1_pos	malignant_1
ATCCGTCCAGTCGGTC-1_pos	malignant_1
ATCCGTCGTGTCCGGT-1_pos	malignant_1
ATCCTATAGAGGACTC-1_pos	malignant_1
ATCCTATAGCTGACAG-1_pos	malignant_1
ATGACCAGTCCATCTC-1_pos	malignant_1
ATGAGTCAGGATTCAA-1_pos	malignant_1
ATGGGAGCAGTCTCTC-1_pos	malignant_1
ATTACTCGTTAAGGAT-1_pos	malignant_1
ATTATCCTCGCAGTCG-1_pos	malignant_1
ATTCACTCAAAGAACT-1_pos	malignant_1
ATTCCCGCACGGATCC-1_pos	malignant_1
ATTCCTATCCTAAGTG-1_pos	malignant_1
ATTCGTTCAACCGTGC-1_pos	malignant_1
ATTCGTTTCATTGCTT-1_pos	malignant_1
ATTCTTGAGACATCCT-1_pos	malignant_1
ATTTCACGTAAGCTCT-1_pos	malignant_1
ATTTCTGTCGGACCAC-1_pos	malignant_1
CAAAGAAGTAGCTTTG-1_pos	malignant_1
CAACCTCAGAATTGTG-1_pos	malignant_1
CAACGGCTCATACAGC-1_pos	malignant_1
CAAGACTGTTGAAGTA-1_pos	malignant_1
CAAGAGGAGATTAGAC-1_pos	malignant_1
CAAGCTACATAGTCAC-1_pos	malignant_1
CAAGCTACATATGAAG-1_pos	malignant_1
CACAGGCAGCGTCAGA-1_pos	malignant_1
CACAGGCGTTGTGTAC-1_pos	malignant_1
CACATGACAAAGCTAA-1_pos	malignant_1
CACCAAAAGAGGCCAT-1_pos	malignant_1
CACCAAACAGTTTCAG-1_pos	malignant_1
CACTAAGTCCAACACA-1_pos	malignant_1
CACTGGGCAATTGAAG-1_pos	malignant_1
CACTGGGCAGCGTGAA-1_pos	malignant_1
CACTGGGGTTCAATCG-1_pos	malignant_1
CACTGTCAGATAGGGA-1_pos	malignant_1
CACTTCGAGACATAAC-1_pos	malignant_1
CAGATCATCCCATTCG-1_pos	malignant_1
CAGATCATCGGCACTG-1_pos	malignant_1
CAGCAATGTCAGACTT-1_pos	malignant_1
CAGCACGCAATGGGTG-1_pos	malignant_1
CAGCAGCGTTTAGACC-1_pos	malignant_1
CAGCGTGCACTTGAAC-1_pos	malignant_1
CAGTGCGTCAAACCCA-1_pos	malignant_1
CATACAGGTAAGCTCT-1_pos	malignant_1
CATCAAGTCATGGATC-1_pos	malignant_1
CATCCCATCGAAGCCC-1_pos	malignant_1
CATCGCTAGAAGAGCA-1_pos	malignant_1
CATCGCTGTACGGTTT-1_pos	malignant_1
CATCGTCGTTTCCCAC-1_pos	malignant_1
CATGAGTTCCTCGATC-1_pos	malignant_1
CATGCAAGTAATGTGA-1_pos	malignant_1
CATGGATAGCACCGTC-1_pos	malignant_1
CATTCCGTCTCAACGA-1_pos	malignant_1
CATTCTAGTAGGCAGT-1_pos	malignant_1
CCACACTCAGCCCAGT-1_pos	malignant_1
CCACACTTCTAGAACC-1_pos	malignant_1
CCACGAGTCCCAGCGA-1_pos	malignant_1
CCACTTGTCAAGTAAG-1_pos	malignant_1
CCATCACGTTACTCAG-1_pos	malignant_1
CCCTAACAGTGGTGGT-1_pos	malignant_1
CCCTAACGTCACTCGG-1_pos	malignant_1
CCCTCAAAGTTTCAGC-1_pos	malignant_1
CCGATGGCAATACAGA-1_pos	malignant_1
CCGCAAGTCTGGTCAA-1_pos	malignant_1
CCGGACACAAACGTGG-1_pos	malignant_1
CCGGACAGTCGTGCCA-1_pos	malignant_1
CCGGTAGGTCAGATTC-1_pos	malignant_1
CCGGTGAAGTTATGGA-1_pos	malignant_1
CCGTGAGGTTTCGACA-1_pos	malignant_1
CCGTTCAAGGCACCAA-1_pos	malignant_1
CCTCATGGTCCATACA-1_pos	malignant_1
CCTTGTGGTTTCAGAC-1_pos	malignant_1
CCTTTGGAGGACGCTA-1_pos	malignant_1
CCTTTGGCACACCTGG-1_pos	malignant_1
CGAATTGTCCCGTTGT-1_pos	malignant_1
CGAGGCTGTGCAAGAC-1_pos	malignant_1
CGAGTTAAGCGCACAA-1_pos	malignant_1
CGCAGGTTCCGTGTAA-1_pos	malignant_1
CGCATAAGTGGACTGA-1_pos	malignant_1
CGCATGGCACTGTTCC-1_pos	malignant_1
CGCATGGGTTGTAAAG-1_pos	malignant_1
CGCGTGACACTCCTGT-1_pos	malignant_1
CGGACACGTGGGAGAG-1_pos	malignant_1
CGGAGAATCCAATCCC-1_pos	malignant_1
CGGGCATCACTGGATT-1_pos	malignant_1
CGGTCAGTCTTCCCAG-1_pos	malignant_1
CGTAATGCACAGTACT-1_pos	malignant_1
CGTGATATCTACACTT-1_pos	malignant_1
CGTTAGAGTCTTTATC-1_pos	malignant_1
CTAACCCCATGGGCAA-1_pos	malignant_1
CTACGGGAGGTGCTTT-1_pos	malignant_1
CTACGGGGTGCAATGG-1_pos	malignant_1
CTACTATTCATGGCCG-1_pos	malignant_1
CTACTATTCGAGTACT-1_pos	malignant_1
CTATCTAGTTGGTAGG-1_pos	malignant_1
CTCAAGACAACACGAG-1_pos	malignant_1
CTCACTGCATAACGGG-1_pos	malignant_1
CTCATCGCACTAACGT-1_pos	malignant_1
CTCATCGTCTAACACG-1_pos	malignant_1
CTCATCGTCTGAGGTT-1_pos	malignant_1
CTCATGCCAATCTGCA-1_pos	malignant_1
CTCCATGGTTGTTGTG-1_pos	malignant_1
CTCCCTCAGGTTGGAC-1_pos	malignant_1
CTCCCTCTCCGCAGTG-1_pos	malignant_1
CTCCTCCAGTTAACAG-1_pos	malignant_1
CTCCTCCTCACCTCTG-1_pos	malignant_1
CTCCTCCTCGCTAGCG-1_pos	malignant_1
CTCGAGGGTCTGTGAT-1_pos	malignant_1
CTCTCGATCATCGTAG-1_pos	malignant_1
CTGAGCGGTTCGATTG-1_pos	malignant_1
CTGCCTATCTCTCAAT-1_pos	malignant_1
CTGGACGAGACTGTTC-1_pos	malignant_1
CTGTACCTCGGTTGTA-1_pos	malignant_1
CTGTAGAAGCTACGTT-1_pos	malignant_1
CTGTAGAAGGAACATT-1_pos	malignant_1
CTTACCGCACAGTGAG-1_pos	malignant_1
CTTCCGACACCGCTGA-1_pos	malignant_1
CTTCCTTTCCGGCAAC-1_pos	malignant_1
CTTCGGTGTGTTGAGG-1_pos	malignant_1
CTTCTAAAGCCGCACT-1_pos	malignant_1
CTTCTAACAATGTCTG-1_pos	malignant_1
CTTTCAACAGGTTTAC-1_pos	malignant_1
CTTTCGGGTGAGACGT-1_pos	malignant_1
GAAGAATCAAGCGAAC-1_pos	malignant_1
GAAGCGACAAGCTGCC-1_pos	malignant_1
GAAGGGTGTAACCCTA-1_pos	malignant_1
GAAGGGTTCGATCCAA-1_pos	malignant_1
GAAGTAATCTGACGCG-1_pos	malignant_1
GAATCGTTCCGTGCGA-1_pos	malignant_1
GACACGCCACAGGATG-1_pos	malignant_1
GACCCAGGTACTCGTA-1_pos	malignant_1
GACCCAGTCGCTCTCA-1_pos	malignant_1
GACCCTTCAGAATCGG-1_pos	malignant_1
GACGCTGAGCGGTAAC-1_pos	malignant_1
GACGCTGCACAGCTGC-1_pos	malignant_1
GACTCAACAAGCGCTC-1_pos	malignant_1
GAGACCCTCCTGTAAG-1_pos	malignant_1
GAGACCCTCGTTCCTG-1_pos	malignant_1
GAGAGGTAGGGATCGT-1_pos	malignant_1
GAGCTGCAGCGGACAT-1_pos	malignant_1
GAGGGTAAGCGCGTTC-1_pos	malignant_1
GAGTCATAGTTTGGCT-1_pos	malignant_1
GAGTGTTCATCGATAC-1_pos	malignant_1
GATAGCTAGGGCAGGA-1_pos	malignant_1
GATCAGTAGTCTCGTA-1_pos	malignant_1
GATCATGGTTGCTAGT-1_pos	malignant_1
GATCATGTCAAGAATG-1_pos	malignant_1
GATGATCAGTCGGCAA-1_pos	malignant_1
GATGCTACACGCGCTA-1_pos	malignant_1
GATGCTAGTCAGCGTC-1_pos	malignant_1
GATGCTAGTTAGGGAC-1_pos	malignant_1
GATTCGATCTTCGGAA-1_pos	malignant_1
GATTTCTAGCACTAAA-1_pos	malignant_1
GATTTCTGTGCTCTCT-1_pos	malignant_1
GATTTCTTCGACGATT-1_pos	malignant_1
GCAACATCAACGTATC-1_pos	malignant_1
GCAACATCATGGTGGA-1_pos	malignant_1
GCAACATTCCGCTGTT-1_pos	malignant_1
GCAGGCTCAAGTGACG-1_pos	malignant_1
GCAGTTATCCATTGTT-1_pos	malignant_1
GCATTAGAGGCTTAGG-1_pos	malignant_1
GCCAACGTCGTTCTAT-1_pos	malignant_1
GCCAGGTCAGCAGTAG-1_pos	malignant_1
GCCAGTGTCTGGCTGG-1_pos	malignant_1
GCCCAGAAGTACTCGT-1_pos	malignant_1
GCCCGAACATCAGCGC-1_pos	malignant_1
GCCGTGACATCCTTCG-1_pos	malignant_1
GCCTGTTTCACTTCTA-1_pos	malignant_1
GCGTGCATCAGACCGC-1_pos	malignant_1
GCGTTTCAGATGGTCG-1_pos	malignant_1
GCGTTTCTCCGGTAAT-1_pos	malignant_1
GCTCAAACAGTCCCGA-1_pos	malignant_1
GCTGGGTGTACGCTTA-1_pos	malignant_1
GCTTCACCAGGCAATG-1_pos	malignant_1
GGAGATGCATCTGTTT-1_pos	malignant_1
GGATGTTCACCGGAAA-1_pos	malignant_1
GGATGTTGTTGAGTCT-1_pos	malignant_1
GGCGTCAAGGGTAATT-1_pos	malignant_1
GGCTTGGTCTTTCCAA-1_pos	malignant_1
GGGACAAGTCTGTCAA-1_pos	malignant_1
GGGACCTAGGATTACA-1_pos	malignant_1
GGGACTCGTCGCTCGA-1_pos	malignant_1
GGGAGTAGTTTACACG-1_pos	malignant_1
GGGATGATCTCCATAT-1_pos	malignant_1
GGGCCATGTCTCAGGC-1_pos	malignant_1
GGGCTACAGCACTAAA-1_pos	malignant_1
GGGCTCACATACCACA-1_pos	malignant_1
GGGTAGATCTGGTGCG-1_pos	malignant_1
GGGTATTTCTGAGCAT-1_pos	malignant_1
GGGTCACCACTTGACA-1_pos	malignant_1
GGGTGTCGTGCGGATA-1_pos	malignant_1
GGGTTATCACAAATCC-1_pos	malignant_1
GGGTTTAGTAACCCTA-1_pos	malignant_1
GGTAATCTCCCGAAAT-1_pos	malignant_1
GGTGATTCATGAATAG-1_pos	malignant_1
GGTTGTAAGGCTGGAT-1_pos	malignant_1
GGTTGTACACCGTGGT-1_pos	malignant_1
GGTTGTATCGGCATCG-1_pos	malignant_1
GTAACCATCTTCTAAC-1_pos	malignant_1
GTAAGTCAGCGTCGAA-1_pos	malignant_1
GTAAGTCTCCATACTT-1_pos	malignant_1
GTAGAAACAGAGATGC-1_pos	malignant_1
GTAGATCAGAAATTGC-1_pos	malignant_1
GTAGGTTCACCCTGAG-1_pos	malignant_1
GTAGGTTGTTCTCTAT-1_pos	malignant_1
GTAGTACTCTTCGACC-1_pos	malignant_1
GTCACGGCAACGATTC-1_pos	malignant_1
GTCAGCGAGTACTGTC-1_pos	malignant_1
GTCAGCGGTCGTATTG-1_pos	malignant_1
GTCATCCGTTAGGAGC-1_pos	malignant_1
GTCATGAGTGGTCCCA-1_pos	malignant_1
GTCATGATCACCCTTG-1_pos	malignant_1
GTCCCATGTACTAACC-1_pos	malignant_1
GTCCTCAAGTGGTGAC-1_pos	malignant_1
GTCCTCAGTACCGCGT-1_pos	malignant_1
GTCGTAAAGAAACCAT-1_pos	malignant_1
GTCTACCAGTCATTGC-1_pos	malignant_1
GTCTGTCGTGCTCTTC-1_pos	malignant_1
GTGCTTCGTACTCGAT-1_pos	malignant_1
GTGGGAACAACAAGAT-1_pos	malignant_1
GTGGTTACAGGACATG-1_pos	malignant_1
GTGTGATCATGGCCCA-1_pos	malignant_1
GTGTTAGAGGCTCACC-1_pos	malignant_1
GTGTTCCTCCGACATA-1_pos	malignant_1
GTTACGACAGCGTTTA-1_pos	malignant_1
GTTATGGTCCATTTCA-1_pos	malignant_1
GTTCGCTCACGGGCTT-1_pos	malignant_1
GTTCGCTGTGGAACAC-1_pos	malignant_1
GTTCGCTTCCATGAGT-1_pos	malignant_1
GTTGTCCGTTATTCCT-1_pos	malignant_1
TAACACGGTGCATTTG-1_pos	malignant_1
TAAGCACAGGTACCTT-1_pos	malignant_1
TAAGCGTAGGACTTCT-1_pos	malignant_1
TAATTCCAGTGGTTAA-1_pos	malignant_1
TACACCCGTGGACTGA-1_pos	malignant_1
TACAGGTCAGGGAATC-1_pos	malignant_1
TACATTCAGGTCGTAG-1_pos	malignant_1
TACCCGTCATATAGCC-1_pos	malignant_1
TACCTCGCATGACGTT-1_pos	malignant_1
TACCTGCAGATCCCAT-1_pos	malignant_1
TACCTGCCAACCGACC-1_pos	malignant_1
TACGTCCTCTATCGCC-1_pos	malignant_1
TACTTACAGGTTCCGC-1_pos	malignant_1
TAGACCACAAATCGGG-1_pos	malignant_1
TAGAGTCAGATGGTCG-1_pos	malignant_1
TAGAGTCTCACTGTCC-1_pos	malignant_1
TAGATCGTCAGCGCGT-1_pos	malignant_1
TAGATCGTCGGCACTG-1_pos	malignant_1
TAGATCGTCTGGACTA-1_pos	malignant_1
TAGCACATCTCAAAGC-1_pos	malignant_1
TAGGAGGAGGTCACCC-1_pos	malignant_1
TAGGGTTAGTTAACGA-1_pos	malignant_1
TAGGTTGTCTAGACAC-1_pos	malignant_1
TATACCTAGGACGCAT-1_pos	malignant_1
TATACCTTCTAGTGAC-1_pos	malignant_1
TATATCCCAGCTGAAG-1_pos	malignant_1
TATATCCTCACTGTCC-1_pos	malignant_1
TATCGCCTCAGTCTTT-1_pos	malignant_1
TATGTTCAGATTGCGG-1_pos	malignant_1
TATGTTCCAAGCTGCC-1_pos	malignant_1
TATGTTCGTCCCACGA-1_pos	malignant_1
TATTCCATCCGGTTCT-1_pos	malignant_1
TATTGGGCAATTCGTG-1_pos	malignant_1
TCAAGACTCCGTAGTA-1_pos	malignant_1
TCACAAGCATAAGCAA-1_pos	malignant_1
TCAGCAATCGAATGCT-1_pos	malignant_1
TCAGGGCTCAGCTCTC-1_pos	malignant_1
TCAGTCCGTGGCGTAA-1_pos	malignant_1
TCAGTCCGTTACACTG-1_pos	malignant_1
TCAGTGAAGCTCGAAG-1_pos	malignant_1
TCATACTCAGACATCT-1_pos	malignant_1
TCATATCAGTCATGCT-1_pos	malignant_1
TCATCCGGTCTCCTGT-1_pos	malignant_1
TCATCCGGTGATGTAA-1_pos	malignant_1
TCATGCCAGGAGAATG-1_pos	malignant_1
TCATGGAAGGATCATA-1_pos	malignant_1
TCATTACAGGGACCAT-1_pos	malignant_1
TCATTGTGTCGTGGAA-1_pos	malignant_1
TCATTTGTCATCAGTG-1_pos	malignant_1
TCCAGAAGTACGGGAT-1_pos	malignant_1
TCCCACACAATACAGA-1_pos	malignant_1
TCCCAGTCAAGGTCAG-1_pos	malignant_1
TCCCAGTTCACGGTCG-1_pos	malignant_1
TCCCATGCAAACGAGC-1_pos	malignant_1
TCCGAAAGTCATATGC-1_pos	malignant_1
TCCGGGACACTACACA-1_pos	malignant_1
TCCTAATCACCAAATC-1_pos	malignant_1
TCCTGCAAGAATGTTG-1_pos	malignant_1
TCCTGCAAGATTTGCC-1_pos	malignant_1
TCGGATACAGACCTGC-1_pos	malignant_1
TCGGTCTCACTTGACA-1_pos	malignant_1
TCGTAGAAGTGGTGAC-1_pos	malignant_1
TCGTCCAGTCAAATCC-1_pos	malignant_1
TCGTCCATCGATACAC-1_pos	malignant_1
TCTACCGCAGACCCGT-1_pos	malignant_1
TCTATCACACGTCATA-1_pos	malignant_1
TCTTCCTTCGACCTAA-1_pos	malignant_1
TGAACGTAGATGATTG-1_pos	malignant_1
TGAACGTCAATCGCAT-1_pos	malignant_1
TGACGCGTCGCGTTTC-1_pos	malignant_1
TGAGGAGAGCACAAAT-1_pos	malignant_1
TGATGGTGTATACCCA-1_pos	malignant_1
TGATTCTAGCAACTCT-1_pos	malignant_1
TGATTTCAGCACTGGA-1_pos	malignant_1
TGCACGGGTCTTGGTA-1_pos	malignant_1
TGCACGGGTGAGTAGC-1_pos	malignant_1
TGCAGATCAAATGCGG-1_pos	malignant_1
TGCAGGCAGCTACTGT-1_pos	malignant_1
TGCAGTACATCATCCC-1_pos	malignant_1
TGCATCCGTCGAACAG-1_pos	malignant_1
TGCGACGCAGCATTGT-1_pos	malignant_1
TGCGGCAAGTAAATGC-1_pos	malignant_1
TGCGGGTAGCGTGAAC-1_pos	malignant_1
TGCTCGTAGTTGCATC-1_pos	malignant_1
TGGAGGAGTCCTCCAT-1_pos	malignant_1
TGGATGTGTGTCGATT-1_pos	malignant_1
TGGGAAGGTTTCGGCG-1_pos	malignant_1
TGGGCGTCACACCAGC-1_pos	malignant_1
TGGGCGTCATTCTTCA-1_pos	malignant_1
TGGGCTGCATAGGAGC-1_pos	malignant_1
TGGGTTACACCAGTTA-1_pos	malignant_1
TGGGTTATCCAACTGA-1_pos	malignant_1
TGGTACACAGAGTGTG-1_pos	malignant_1
TGGTACACATGACTGT-1_pos	malignant_1
TGGTAGTTCATCGCCT-1_pos	malignant_1
TGGTTAGCAGAACTCT-1_pos	malignant_1
TGGTTAGTCGACCATA-1_pos	malignant_1
TGTAAGCAGAAGGCTC-1_pos	malignant_1
TGTAGACAGTTTGAGA-1_pos	malignant_1
TGTCCACCAATTGGTC-1_pos	malignant_1
TGTCCCAAGGCTGTAG-1_pos	malignant_1
TGTCCTGAGTCTGGTT-1_pos	malignant_1
TGTCCTGGTGGTACAG-1_pos	malignant_1
TGTGAGTAGTAAATGC-1_pos	malignant_1
TGTTCTATCTTGGCTC-1_pos	malignant_1
TGTTTGTTCACGTAGT-1_pos	malignant_1
TTAATCCCATCATCTT-1_pos	malignant_1
TTAATCCTCACCTGTC-1_pos	malignant_1
TTACCATAGCTTCATG-1_pos	malignant_1
TTACCATTCGTCCTCA-1_pos	malignant_1
TTACCGCGTACCCACG-1_pos	malignant_1
TTAGGCACACTCGATA-1_pos	malignant_1
TTAGTCTCAGTTCACA-1_pos	malignant_1
TTAGTCTCATCGCTAA-1_pos	malignant_1
TTCAATCCACTGTCGG-1_pos	malignant_1
TTCACGCAGATCCCAT-1_pos	malignant_1
TTCAGGAGTTATAGCC-1_pos	malignant_1
TTCATGTAGACTCATC-1_pos	malignant_1
TTCATTGAGCAACAAT-1_pos	malignant_1
TTCCAATTCACAGTGT-1_pos	malignant_1
TTCCAATTCCATTCGC-1_pos	malignant_1
TTCCGTGGTTACACAC-1_pos	malignant_1
TTCGCTGGTGACTCGC-1_pos	malignant_1
TTCGCTGTCTCGAGTA-1_pos	malignant_1
TTCTTCCCACATCATG-1_pos	malignant_1
TTCTTGAAGCGGATCA-1_pos	malignant_1
TTCTTGAGTCCATAGT-1_pos	malignant_1
TTGAGTGCACGCGTCA-1_pos	malignant_1
TTGGATGAGCACTCTA-1_pos	malignant_1
TTGGATGAGGCCCGTT-1_pos	malignant_1
TTGGTTTTCTGAGATC-1_pos	malignant_1
TTGTTGTCAACTGCTA-1_pos	malignant_1
TTTACCATCACCTGTC-1_pos	malignant_1
TTTACCATCCCTCTAG-1_pos	malignant_1
TTTATGCTCGTGTGAT-1_pos	malignant_1
TTTCAGTTCGTCTCAC-1_pos	malignant_1
TTTCGATCATGCCATA-1_pos	malignant_1
AAAGGATTCCAGGACC-1_pos	malignant_11
AAAGGTAGTACCGCGT-1_pos	malignant_11
AACAAAGAGATAGCTA-1_pos	malignant_11
AACAGGGTCGGACCAC-1_pos	malignant_11
AACCACATCATTCGTT-1_pos	malignant_11
AACCTGATCGAGAACG-1_pos	malignant_11
AACGAAAAGTCATGCT-1_pos	malignant_11
AACGAAAGTTGTTGAC-1_pos	malignant_11
AAGCGAGAGAGAGCAA-1_pos	malignant_11
AAGGAATCACATTCTT-1_pos	malignant_11
AATGACCTCTGCGAGC-1_pos	malignant_11
AATGGAAAGCTTAGTC-1_pos	malignant_11
AATGGCTTCGAGCACC-1_pos	malignant_11
ACAAGCTGTGTGTGTT-1_pos	malignant_11
ACCATTTAGAGTCAAT-1_pos	malignant_11
ACGATCAGTGCCCACA-1_pos	malignant_11
ACGATCATCCCTTCCC-1_pos	malignant_11
ACGCACGTCTCTATAC-1_pos	malignant_11
ACTATTCAGCCTGTCG-1_pos	malignant_11
ACTCTCGCACAAGCCC-1_pos	malignant_11
AGAACAATCGTGGGTC-1_pos	malignant_11
AGACACTCATGACGTT-1_pos	malignant_11
AGAGCAGAGGGCTAAC-1_pos	malignant_11
AGCTCAAAGTGGGAAA-1_pos	malignant_11
AGGGAGTAGGCTTTCA-1_pos	malignant_11
AGGGAGTAGTGGGAAA-1_pos	malignant_11
AGGGAGTTCAAGCCAT-1_pos	malignant_11
AGGGCCTAGGTCATAA-1_pos	malignant_11
AGGTGTTTCACTTTGT-1_pos	malignant_11
AGTACCACAGAGGTTG-1_pos	malignant_11
AGTACTGGTATGTCCA-1_pos	malignant_11
AGTCAACAGGTTGGTG-1_pos	malignant_11
AGTTCGAAGGGTTAGC-1_pos	malignant_11
AGTTCGAAGTTTAGGA-1_pos	malignant_11
ATACTTCCACAGTCCG-1_pos	malignant_11
ATCACGAGTCCACACG-1_pos	malignant_11
ATCGTGAAGATCACCT-1_pos	malignant_11
ATGACCAGTTCGGTCG-1_pos	malignant_11
ATGGATCGTGCGACAA-1_pos	malignant_11
ATGTCCCGTTGGGTAG-1_pos	malignant_11
ATTATCCAGTGAATAC-1_pos	malignant_11
ATTTCTGTCAAGCTTG-1_pos	malignant_11
ATTTCTGTCGAATGCT-1_pos	malignant_11
CAAGCTATCATGACAC-1_pos	malignant_11
CACGTGGAGAAACACT-1_pos	malignant_11
CACTGGGTCGATTGGT-1_pos	malignant_11
CAGATCACAATACCCA-1_pos	malignant_11
CATAGACAGAGGGTGG-1_pos	malignant_11
CATCCACGTGTGTACT-1_pos	malignant_11
CATGCAAAGCTCCATA-1_pos	malignant_11
CATTCATTCCTGGGAC-1_pos	malignant_11
CCAAGCGAGTGATGGC-1_pos	malignant_11
CCACAAAGTCACTACA-1_pos	malignant_11
CCATAAGCAGCGGTCT-1_pos	malignant_11
CCATAAGGTAGAGGAA-1_pos	malignant_11
CCCAACTTCGTAACTG-1_pos	malignant_11
CCGATCTGTATCATGC-1_pos	malignant_11
CCGGGTATCGCTCATC-1_pos	malignant_11
CCGTGAGCAAATCAAG-1_pos	malignant_11
CCGTTCACACACGGAA-1_pos	malignant_11
CCTAACCCAAGAGATT-1_pos	malignant_11
CCTAAGAAGCGTACAG-1_pos	malignant_11
CCTCAGTGTGTGGACA-1_pos	malignant_11
CCTCCAACACAAATAG-1_pos	malignant_11
CGAAGGATCAGACTGT-1_pos	malignant_11
CGAATTGCAGATTCGT-1_pos	malignant_11
CGAGTTACACGGGTAA-1_pos	malignant_11
CGGCAGTCAAAGTATG-1_pos	malignant_11
CGGGACTTCATGTCAG-1_pos	malignant_11
CGTGATATCTTTCCGG-1_pos	malignant_11
CTAACCCGTGAGCTCC-1_pos	malignant_11
CTCGAGGCACGCTGTG-1_pos	malignant_11
CTGAATGTCCATCAGA-1_pos	malignant_11
CTGCATCGTACGGGAT-1_pos	malignant_11
CTGCGAGAGCGAGTCA-1_pos	malignant_11
CTTCCTTCAGACCCGT-1_pos	malignant_11
GAACTGTTCACACCGG-1_pos	malignant_11
GAAGCCCAGATGCTTC-1_pos	malignant_11
GACAGCCTCCGTCAAA-1_pos	malignant_11
GACATCAGTGTTCGTA-1_pos	malignant_11
GACATCATCTGAATCG-1_pos	malignant_11
GAGACCCTCGCCAGAC-1_pos	malignant_11
GAGATGGAGCCAGTAG-1_pos	malignant_11
GAGGCAACACGGCTAC-1_pos	malignant_11
GAGTTGTGTTGCCAAT-1_pos	malignant_11
GATGACTCATTGAAGA-1_pos	malignant_11
GCAACATAGGTTGTTC-1_pos	malignant_11
GCACTAAGTACCCACG-1_pos	malignant_11
GCAGCTGTCCGCACTT-1_pos	malignant_11
GCAGTTATCGGCACTG-1_pos	malignant_11
GCCAACGAGCGTCTGC-1_pos	malignant_11
GCTCAAATCGTCACCT-1_pos	malignant_11
GGGAGTAGTGTCGATT-1_pos	malignant_11
GGGCTACCAAAGCTCT-1_pos	malignant_11
GGGCTACGTCCGCAGT-1_pos	malignant_11
GGGTGAAAGTGCGACA-1_pos	malignant_11
GGGTGAACAAGAGGCT-1_pos	malignant_11
GGGTGAAGTAACATAG-1_pos	malignant_11
GTAAGTCCAGCTGCCA-1_pos	malignant_11
GTAGGTTTCATCGGGC-1_pos	malignant_11
GTATTGGCACATTACG-1_pos	malignant_11
GTATTTCTCGGTCAGC-1_pos	malignant_11
GTCACTCTCGAGCACC-1_pos	malignant_11
GTCATTTCAAGAATAC-1_pos	malignant_11
GTGATGTAGTACTGTC-1_pos	malignant_11
GTGCGTGCACCAAAGG-1_pos	malignant_11
GTGCTGGCATGGGATG-1_pos	malignant_11
GTGGGAACAGAATGTA-1_pos	malignant_11
GTGTGATCAACCCGCA-1_pos	malignant_11
GTTACCCTCAGAACCT-1_pos	malignant_11
GTTCCGTCAATTGGTC-1_pos	malignant_11
TAAGCACAGATGAAGG-1_pos	malignant_11
TACAACGGTCTTACTT-1_pos	malignant_11
TACAGGTTCATGGTAC-1_pos	malignant_11
TACCCGTGTCATCACA-1_pos	malignant_11
TACGGTAGTCATGACT-1_pos	malignant_11
TACTGCCCAATGCAAA-1_pos	malignant_11
TACTTCAGTGTTCCTC-1_pos	malignant_11
TATCCTAAGGTTGGTG-1_pos	malignant_11
TATTGGGTCGCCGAGT-1_pos	malignant_11
TCAATCTGTTTCAGAC-1_pos	malignant_11
TCAATTCTCCAACCGG-1_pos	malignant_11
TCATCATGTCTGCCTT-1_pos	malignant_11
TCGAACAGTTCACGAT-1_pos	malignant_11
TCGAAGTTCAGCTTCC-1_pos	malignant_11
TCGACCTTCTTCCGTG-1_pos	malignant_11
TCGCAGGAGCAAGCCA-1_pos	malignant_11
TCGCTCAGTGTACAGG-1_pos	malignant_11
TCGCTTGGTGTCCAAT-1_pos	malignant_11
TCGGATATCGCCGATG-1_pos	malignant_11
TCGGGTGCAGATCCTA-1_pos	malignant_11
TCGTAGATCGTGGAAG-1_pos	malignant_11
TCTAACTGTTCCATTT-1_pos	malignant_11
TCTACATGTTCGAACT-1_pos	malignant_11
TCTCTGGTCCAAGCTA-1_pos	malignant_11
TCTTCCTTCAAGAGTA-1_pos	malignant_11
TCTTTGAGTAACCCTA-1_pos	malignant_11
TGACCCTGTGACTCGC-1_pos	malignant_11
TGCAGGCTCCTACAAG-1_pos	malignant_11
TGCCGAGCATGATAGA-1_pos	malignant_11
TGCTTCGTCTGATGGT-1_pos	malignant_11
TGGCGTGAGGAGGCAG-1_pos	malignant_11
TGGGCTGTCGCATGAT-1_pos	malignant_11
TGGTACATCGATTTCT-1_pos	malignant_11
TGGTGATGTTCGGTAT-1_pos	malignant_11
TGTAACGCAACGACTT-1_pos	malignant_11
TGTAGACTCCATTTGT-1_pos	malignant_11
TGTGAGTGTTCACGAT-1_pos	malignant_11
TGTGATGTCTTAGCAG-1_pos	malignant_11
TGTTCATCATCATTGG-1_pos	malignant_11
TTACCGCGTCCCAAAT-1_pos	malignant_11
TTCACGCAGACCCGCT-1_pos	malignant_11
TTCTTCCGTACCCGAC-1_pos	malignant_11
TTGACCCTCTTTGCTA-1_pos	malignant_11
TTGTTCACAGCTACTA-1_pos	malignant_11
TTGTTTGCACCTGTCT-1_pos	malignant_11
TTTATGCGTCTCACGG-1_pos	malignant_11
TTTATGCTCAGAGTGG-1_pos	malignant_11
TTTCACAGTTTAGTCG-1_pos	malignant_11
AAAGAACGTTCAGCTA-1_pos	malignant_12
AAAGGTACACTTCATT-1_pos	malignant_12
AAAGTGATCGAATCCA-1_pos	malignant_12
AAGACAAAGCTGTGCC-1_pos	malignant_12
AATTCCTCAGCGCTTG-1_pos	malignant_12
ACAAAGAAGGTATTGA-1_pos	malignant_12
ACCCTTGCAGTTAGGG-1_pos	malignant_12
ACGATGTAGAGGTCAC-1_pos	malignant_12
ACTACGACAGCTCCTT-1_pos	malignant_12
ACTTAGGAGCGCTTCG-1_pos	malignant_12
AGAGAATTCTGCTGAA-1_pos	malignant_12
AGCGCTGAGATCCAAA-1_pos	malignant_12
AGCTACATCCACAGCG-1_pos	malignant_12
AGCTCAAGTAGCTAAA-1_pos	malignant_12
AGCTCAATCGAACACT-1_pos	malignant_12
AGGCTGCAGCCACAAG-1_pos	malignant_12
AGGGTCCAGGGAGGAC-1_pos	malignant_12
AGGTAGGTCAAGGAGC-1_pos	malignant_12
AGGTTACAGCGTCTGC-1_pos	malignant_12
AGTACTGGTCCAGCGT-1_pos	malignant_12
AGTCAACAGATTGGGC-1_pos	malignant_12
ATCACGAAGGTTGGAC-1_pos	malignant_12
ATCATTCGTCTCGGAC-1_pos	malignant_12
ATGATCGGTAGACAGC-1_pos	malignant_12
ATGGAGGGTGTAAATG-1_pos	malignant_12
ATGTCTTGTTAGGACG-1_pos	malignant_12
ATTCTACCACCTATCC-1_pos	malignant_12
ATTCTACGTACAACGG-1_pos	malignant_12
CACACAAAGTATCTGC-1_pos	malignant_12
CACGGGTAGTGCACTT-1_pos	malignant_12
CAGATTGGTCTGGTTA-1_pos	malignant_12
CAGCAATAGGACAACC-1_pos	malignant_12
CAGGGCTAGGTTCCAT-1_pos	malignant_12
CAGTTCCAGCGGCTCT-1_pos	malignant_12
CATACAGCAGAGGTTG-1_pos	malignant_12
CATGCAACAGTCGCAC-1_pos	malignant_12
CCGAACGAGCACCAGA-1_pos	malignant_12
CCGATCTCAGTCTGGC-1_pos	malignant_12
CCGATGGTCGTCAACA-1_pos	malignant_12
CCGTAGGCAAGTTGGG-1_pos	malignant_12
CGATGGCCACAGGATG-1_pos	malignant_12
CGTCAAAAGGCAGCTA-1_pos	malignant_12
CTCCTCCTCCCTATTA-1_pos	malignant_12
CTGATCCTCCTACGGG-1_pos	malignant_12
CTGCGAGGTCCATACA-1_pos	malignant_12
CTGCGAGGTTAAGAAC-1_pos	malignant_12
CTGCTCATCTTCCAGC-1_pos	malignant_12
GAAGCCCAGACGGTCA-1_pos	malignant_12
GAGAGGTCATTGAAGA-1_pos	malignant_12
GAGGCCTGTAAGGAGA-1_pos	malignant_12
GAGTTGTAGGCCTTGC-1_pos	malignant_12
GATCATGAGTAAACGT-1_pos	malignant_12
GATCGTATCTAACACG-1_pos	malignant_12
GATGAGGTCCGTGCGA-1_pos	malignant_12
GATGATCCAAAGGGTC-1_pos	malignant_12
GATTGGTTCGTCTCAC-1_pos	malignant_12
GCACGGTTCAAGAGTA-1_pos	malignant_12
GCAGGCTAGTCTGGAG-1_pos	malignant_12
GCATTAGGTTGGGCCT-1_pos	malignant_12
GCCAACGAGTGCACTT-1_pos	malignant_12
GCCAGGTAGTGCAGCA-1_pos	malignant_12
GCCATGGTCCACCTCA-1_pos	malignant_12
GCTACAAAGGACTGGT-1_pos	malignant_12
GCTGAATCAATTAGGA-1_pos	malignant_12
GCTGCAGGTGCGGCTT-1_pos	malignant_12
GCTGGGTTCAAACCCA-1_pos	malignant_12
GGAATCTGTAGTGCGA-1_pos	malignant_12
GGAATCTGTCAGGTAG-1_pos	malignant_12
GGCAGTCGTCTTACTT-1_pos	malignant_12
GGCAGTCTCAGGGTAG-1_pos	malignant_12
GGTCTGGTCTGTGCTC-1_pos	malignant_12
GGTTGTATCCGTGGGT-1_pos	malignant_12
GTAACCAGTCGCACAC-1_pos	malignant_12
GTAAGTCTCCCTGTTG-1_pos	malignant_12
GTAGAGGCACACAGCC-1_pos	malignant_12
GTCAAACAGCCTCCAG-1_pos	malignant_12
GTCAAACGTCAGCTTA-1_pos	malignant_12
GTGAGTTAGGGTCACA-1_pos	malignant_12
GTGTAACCAAATTGGA-1_pos	malignant_12
GTTGAACCAGCACAGA-1_pos	malignant_12
TAAGCCAGTCACCGCA-1_pos	malignant_12
TACAGGTGTTATCTTC-1_pos	malignant_12
TACCGGGTCGTCAGAT-1_pos	malignant_12
TACCTGCGTCACCTTC-1_pos	malignant_12
TACGCTCGTGTCTTAG-1_pos	malignant_12
TACTTCAGTGGCCACT-1_pos	malignant_12
TAGCACATCACAACCA-1_pos	malignant_12
TATTGCTAGCCTATTG-1_pos	malignant_12
TATTGGGAGGAAAGTG-1_pos	malignant_12
TCAAGCAGTCCTCCTA-1_pos	malignant_12
TCACGCTCATGTCAGT-1_pos	malignant_12
TCCCACAAGCTGACTT-1_pos	malignant_12
TCCGATCGTGAATAAC-1_pos	malignant_12
TCGAAGTTCATGGAGG-1_pos	malignant_12
TCGACGGAGAGAGCAA-1_pos	malignant_12
TCGACGGAGATAACAC-1_pos	malignant_12
TCGGGTGCAGCGAACA-1_pos	malignant_12
TCGTAGAGTGGCTGCT-1_pos	malignant_12
TCGTCCAGTACAAACA-1_pos	malignant_12
TCTGGCTCACATAACC-1_pos	malignant_12
TCTTTGAGTGAGATTA-1_pos	malignant_12
TGAGGAGCAGCGCTTG-1_pos	malignant_12
TGATTTCGTCTGTAGT-1_pos	malignant_12
TGATTTCTCTCCAATT-1_pos	malignant_12
TGCACGGAGTTTCGGT-1_pos	malignant_12
TGCAGTAAGTAATACG-1_pos	malignant_12
TGTAGACTCGCATAGT-1_pos	malignant_12
TTCGCTGTCTCGTTTA-1_pos	malignant_12
TTCTCTCTCCATATGG-1_pos	malignant_12
TTGACCCTCAAGTGTC-1_pos	malignant_12
TTGCGTCCACGCTTAA-1_pos	malignant_12
TTTCACATCGACCAAT-1_pos	malignant_12
AACTTCTGTGTTAAAG-1_pos	malignant_13
AAGGAATAGTATTCCG-1_pos	malignant_13
ACACGCGCAGTGTATC-1_pos	malignant_13
ACTTCGCAGAATCGTA-1_pos	malignant_13
AGAGAGCGTATTTCGG-1_pos	malignant_13
AGATAGAGTCCCAAAT-1_pos	malignant_13
AGGGAGTGTATCTCGA-1_pos	malignant_13
AGGTGTTCACGAGGAT-1_pos	malignant_13
AGTCACATCGTAGCTA-1_pos	malignant_13
ATCAGGTAGATGGGCT-1_pos	malignant_13
ATTGGGTGTACAGTTC-1_pos	malignant_13
CAACAACTCTGATGGT-1_pos	malignant_13
CAGGCCACAGAGATTA-1_pos	malignant_13
CCACACTAGACCAACG-1_pos	malignant_13
CCACCATGTCGTGATT-1_pos	malignant_13
CCATAAGCACCGTGCA-1_pos	malignant_13
CCTGCATAGGACTGGT-1_pos	malignant_13
CTAACCCAGAAGCGGG-1_pos	malignant_13
CTAGACAAGTACCATC-1_pos	malignant_13
CTCATCGAGGTAGCAC-1_pos	malignant_13
CTGGCAGAGTTTCTTC-1_pos	malignant_13
GAGAAATTCTCCTGCA-1_pos	malignant_13
GAGACTTGTTGCATTG-1_pos	malignant_13
GAGGGTAAGTAGAATC-1_pos	malignant_13
GAGTGAGCAGGTTTAC-1_pos	malignant_13
GAGTTTGGTAACCAGG-1_pos	malignant_13
GATCCCTAGTCTGCGC-1_pos	malignant_13
GATGTTGCACGTTCGG-1_pos	malignant_13
GATGTTGTCGAAGAAT-1_pos	malignant_13
GCACTAACATTCATCT-1_pos	malignant_13
GGAGCAAAGGGCTGAT-1_pos	malignant_13
GGGCTCAGTACGTAGG-1_pos	malignant_13
GGGTCACCAGACAAAT-1_pos	malignant_13
GTAACCACAACGTAAA-1_pos	malignant_13
GTACAGTTCCCTCATG-1_pos	malignant_13
GTCGCGAGTACATACC-1_pos	malignant_13
GTGCTGGAGTTTCAGC-1_pos	malignant_13
TACTTACGTACAAAGT-1_pos	malignant_13
TCAATTCCACAGACGA-1_pos	malignant_13
TCCAGAATCTCCGCAT-1_pos	malignant_13
TCGGGTGCAGACGCTC-1_pos	malignant_13
TGAGTCAAGACTAAGT-1_pos	malignant_13
TGATTTCAGCTGTACT-1_pos	malignant_13
TGTCCCACATAATGAG-1_pos	malignant_13
TTAATCCTCGCCTTTG-1_pos	malignant_13
TTCAATCGTGTGTGGA-1_pos	malignant_13
TTGGGATTCGCTATTT-1_pos	malignant_13
TTGTTGTAGCATCAGG-1_pos	malignant_13
AACGGGATCGCTACGG-1_pos	malignant_14
AAGTGAACAAGCGAAC-1_pos	malignant_14
ATGAGTCAGTGCCAGA-1_pos	malignant_14
CATGCGGAGCGCTGCT-1_pos	malignant_14
CCAATGACATCCGTGG-1_pos	malignant_14
CGTAATGCAGGCACAA-1_pos	malignant_14
CTCAGGGTCTAGCCAA-1_pos	malignant_14
CTCCCTCCATGGACAG-1_pos	malignant_14
GATGATCAGGCTATCT-1_pos	malignant_14
GCTTCACGTCGCTGCA-1_pos	malignant_14
GGAGCAAGTTGTCAGT-1_pos	malignant_14
GGCTTTCGTTATGACC-1_pos	malignant_14
GTAATGCGTTGCGTAT-1_pos	malignant_14
TACAGGTTCTATCACT-1_pos	malignant_14
TACCCGTCAGGCATTT-1_pos	malignant_14
TTGGGATGTGCATCTA-1_pos	malignant_14
AAACGAATCGAAGAAT-1_pos	malignant_15
AAACGCTTCGTAGAGG-1_pos	malignant_15
AAAGAACGTCTAGATC-1_pos	malignant_15
ACCACAAAGGTTGCCC-1_pos	malignant_15
ACTTATCTCTCATAGG-1_pos	malignant_15
AGACCCGGTGAACCGA-1_pos	malignant_15
AGTCATGCAGAATCGG-1_pos	malignant_15
ATTACTCCAGGGCTTC-1_pos	malignant_15
CAACGGCAGAGATCGC-1_pos	malignant_15
CAATACGAGATAACAC-1_pos	malignant_15
CATCGGGCACTCATAG-1_pos	malignant_15
GAACTGTAGTTGAAAC-1_pos	malignant_15
GGAAGTGAGGGATGTC-1_pos	malignant_15
GTATTTCAGAGCTGCA-1_pos	malignant_15
TACTTACGTACACTCA-1_pos	malignant_15
TCCTCCCAGTACGAGC-1_pos	malignant_15
TCGATTTAGCACCTGC-1_pos	malignant_15
AAAGTCCTCAAGTAAG-1_pos	malignant_17
ACACTGATCAGCCTTC-1_pos	malignant_17
AGACCATAGACTACGG-1_pos	malignant_17
AGGCCACAGGACTGGT-1_pos	malignant_17
ATACCTTCAGCGCTTG-1_pos	malignant_17
CAGTGCGTCAAGCGTT-1_pos	malignant_17
CATCCACTCACCACAA-1_pos	malignant_17
CATGCAAAGTAACGTA-1_pos	malignant_17
CCACTTGTCCTTCTAA-1_pos	malignant_17
CCTCTAGCACCCGTAG-1_pos	malignant_17
CCTGTTGAGGTAAGGA-1_pos	malignant_17
CGGACACGTGAACTAA-1_pos	malignant_17
CGTTAGAGTAGTCTTG-1_pos	malignant_17
CTACAGAAGGACGCTA-1_pos	malignant_17
CTCATCGGTAAGTTAG-1_pos	malignant_17
GACTATGTCAAGCGTT-1_pos	malignant_17
GATTCGAGTGCAGTGA-1_pos	malignant_17
GCAGTTACACAGCCAC-1_pos	malignant_17
GGGATGAGTCTCCTGT-1_pos	malignant_17
GGGTCACTCGAGAGAC-1_pos	malignant_17
GGTCACGGTCACCACG-1_pos	malignant_17
GGTTCTCTCGTCCTCA-1_pos	malignant_17
GTCAGCGTCGGCTATA-1_pos	malignant_17
GTGTGGCAGGCTTTCA-1_pos	malignant_17
TACAGGTGTTTGAAAG-1_pos	malignant_17
TATCGCCCAACTGATC-1_pos	malignant_17
TCCAGAAAGTCTAGCT-1_pos	malignant_17
TCCTCGAAGTTAACGA-1_pos	malignant_17
TCCTCTTCACCCTGAG-1_pos	malignant_17
TCGGGACAGCGTGTTT-1_pos	malignant_17
TCTATCACAGTCCGTG-1_pos	malignant_17
TGCAGATTCAAGGTGG-1_pos	malignant_17
TTATTGCGTGAGTCAG-1_pos	malignant_17
AAACCCATCTGCAGCG-1_pos	malignant_18
AAACGCTGTTGGTAGG-1_pos	malignant_18
AACAACCAGCTAATCC-1_pos	malignant_18
AACAAGAAGAAGCCTG-1_pos	malignant_18
ACAAGCTCAATTGAAG-1_pos	malignant_18
ACATCGATCATCACAG-1_pos	malignant_18
ACGGTCGAGTCTTGGT-1_pos	malignant_18
ACGGTTACAGTGCGCT-1_pos	malignant_18
ACGTCCTGTACACGTT-1_pos	malignant_18
AGACCATTCATTGGTG-1_pos	malignant_18
AGAGCCCGTACTTCCC-1_pos	malignant_18
AGATCCAAGCTCATAC-1_pos	malignant_18
AGCCAATTCTTCGCTG-1_pos	malignant_18
AGCGCCACAACTAGAA-1_pos	malignant_18
AGCGCTGCACCAGCTG-1_pos	malignant_18
AGGCCACGTGATACCT-1_pos	malignant_18
ATACCGACACGGATCC-1_pos	malignant_18
ATACCGACAGTCTCTC-1_pos	malignant_18
ATCACGACACATACTG-1_pos	malignant_18
ATCGGATAGCACGGAT-1_pos	malignant_18
ATGAAAGTCCGAGTGC-1_pos	malignant_18
ATGAGTCTCAACTCTT-1_pos	malignant_18
ATGCGATTCAACCGAT-1_pos	malignant_18
ATGGAGGAGCTGGAGT-1_pos	malignant_18
ATGGAGGCATGCCGGT-1_pos	malignant_18
ATGGAGGTCTACGGTA-1_pos	malignant_18
ATGGGAGAGTAAAGCT-1_pos	malignant_18
ATTCCTAGTCAACATC-1_pos	malignant_18
CAAGAGGCATAGTCAC-1_pos	malignant_18
CACCGTTAGCTAATGA-1_pos	malignant_18
CACTAAGAGTCTGGAG-1_pos	malignant_18
CACTGAACATCTCGTC-1_pos	malignant_18
CAGATACTCTACAGGT-1_pos	malignant_18
CATCAAGCATGGCTGC-1_pos	malignant_18
CATCCCAAGACGAGCT-1_pos	malignant_18
CATGAGTTCCATACTT-1_pos	malignant_18
CATGCAACATCACGGC-1_pos	malignant_18
CCAATGACATACCAGT-1_pos	malignant_18
CCACAAAGTCGCAGTC-1_pos	malignant_18
CCATAAGTCTTCCACG-1_pos	malignant_18
CCCTCAAAGCTGAGCA-1_pos	malignant_18
CCGTAGGAGACCATTC-1_pos	malignant_18
CCTCAGTAGTAGCCAG-1_pos	malignant_18
CGAGAAGGTCTGCCTT-1_pos	malignant_18
CGAGTGCAGGTCACTT-1_pos	malignant_18
CGAGTGCTCCCTCAAC-1_pos	malignant_18
CGATCGGTCTGTTCAT-1_pos	malignant_18
CGATGGCCATACCGTA-1_pos	malignant_18
CGCCATTCATGGCACC-1_pos	malignant_18
CGTTCTGTCTTAGTTC-1_pos	malignant_18
CTAAGTGAGATGTTCC-1_pos	malignant_18
CTACTATGTTACAGCT-1_pos	malignant_18
CTCCCAAAGGATCATA-1_pos	malignant_18
CTCCTTTCATATGCGT-1_pos	malignant_18
CTCCTTTGTTGACTAC-1_pos	malignant_18
CTTACCGCAGCCGTCA-1_pos	malignant_18
CTTCTCTTCTTCGCTG-1_pos	malignant_18
GAAACCTGTGCTGTCG-1_pos	malignant_18
GAAGTAATCAGGGATG-1_pos	malignant_18
GACTATGTCGTTCTGC-1_pos	malignant_18
GAGGGATGTCGATTAC-1_pos	malignant_18
GATGAGGAGTGCGCTC-1_pos	malignant_18
GATGATCGTATCAAGA-1_pos	malignant_18
GATGCTAGTACCTTCC-1_pos	malignant_18
GATGTTGGTGAGACCA-1_pos	malignant_18
GCCAGTGGTACAGAGC-1_pos	malignant_18
GCTGGGTCACGGTGAA-1_pos	malignant_18
GCTTGGGTCACCATCC-1_pos	malignant_18
GCTTTCGAGATCCGAG-1_pos	malignant_18
GCTTTCGGTTAGAGTA-1_pos	malignant_18
GGAACCCTCTTCGGTC-1_pos	malignant_18
GGACGTCAGTTACGTC-1_pos	malignant_18
GGAGGATTCATGAGGG-1_pos	malignant_18
GGGCGTTCACTTCAGA-1_pos	malignant_18
GGGCTACCAAAGCTAA-1_pos	malignant_18
GGTAGAGAGTGAGGCT-1_pos	malignant_18
GTAAGTCTCTAGAGCT-1_pos	malignant_18
GTCTGTCCACGAGGTA-1_pos	malignant_18
GTGCGTGCAAGTATCC-1_pos	malignant_18
GTGCTTCTCAAGCCCG-1_pos	malignant_18
GTGTAACCAACGACTT-1_pos	malignant_18
GTTACAGGTCGCATTA-1_pos	malignant_18
GTTAGTGCAAAGACTA-1_pos	malignant_18
GTTTACTTCCAACCGG-1_pos	malignant_18
TAAGTCGGTACTGGGA-1_pos	malignant_18
TAGATCGCACTCAGAT-1_pos	malignant_18
TAGCACATCGTCCATC-1_pos	malignant_18
TATTGCTAGCCTTCTC-1_pos	malignant_18
TCAGGTATCTCGACGG-1_pos	malignant_18
TCCAGAAGTCTCACGG-1_pos	malignant_18
TCCGGGAGTACGGTTT-1_pos	malignant_18
TCGACGGCATTCCTAT-1_pos	malignant_18
TCGATTTGTAATCAAG-1_pos	malignant_18
TCTGGCTTCCGACGGT-1_pos	malignant_18
TCTTTGATCCTCGATC-1_pos	malignant_18
TGCGGCATCAATCAGC-1_pos	malignant_18
TGCTGAAAGGGCCTCT-1_pos	malignant_18
TGGGAGATCGACCATA-1_pos	malignant_18
TGTAACGGTAAGTTGA-1_pos	malignant_18
TTACGTTTCATTACCT-1_pos	malignant_18
TTATTGCCATAGGTTC-1_pos	malignant_18
TTCTTGACAACCGACC-1_pos	malignant_18
TTGATGGCATCGAGCC-1_pos	malignant_18
TTGGTTTTCGTCCTTG-1_pos	malignant_18
TTGTTCAAGTGAGTTA-1_pos	malignant_18
AAGCGTTTCATCGCCT-1_pos	malignant_25
ACGGTCGAGGCACTCC-1_pos	malignant_25
AGACTCACATTGACCA-1_pos	malignant_25
AGATCCACATGCCGAC-1_pos	malignant_25
AGATGAAAGTCTCGTA-1_pos	malignant_25
AGGACTTGTTCTCCTG-1_pos	malignant_25
AGTAACCCAGATTCGT-1_pos	malignant_25
ATCTCTAGTGACAGCA-1_pos	malignant_25
CCGGACACACACGTGC-1_pos	malignant_25
CGATGGCAGGTTCCAT-1_pos	malignant_25
CTCAGGGAGGACACTG-1_pos	malignant_25
CTCATTAGTCGCAACC-1_pos	malignant_25
CTGGCAGTCTCACCCA-1_pos	malignant_25
CTGTCGTAGCCAGACA-1_pos	malignant_25
GCTTGGGCATGGAATA-1_pos	malignant_25
GGGACTCTCGTGGGAA-1_pos	malignant_25
GGTGAAGAGAGGTATT-1_pos	malignant_25
GTGTAACTCTAGGCCG-1_pos	malignant_25
TACTTACCAAGTGGAC-1_pos	malignant_25
TAGGTTGGTGTGAATA-1_pos	malignant_25
TCGCACTCACAACGCC-1_pos	malignant_25
TCTCTGGGTGCATTTG-1_pos	malignant_25
TCTTCCTCACCGCTGA-1_pos	malignant_25
TGCGGCAAGACGCTCC-1_pos	malignant_25
TTCGCTGAGCCACTCG-1_pos	malignant_25
TTGCGTCAGCCTCTTC-1_pos	malignant_25
AACCACAAGGTACCTT-1_pos	malignant_27
AATGCCACAATGACCT-1_pos	malignant_27
ACGATCAAGATCCCGC-1_pos	malignant_27
ACGTTCCGTTGGAGAC-1_pos	malignant_27
ACTACGATCCGATCTC-1_pos	malignant_27
ACTCCCACAATCGAAA-1_pos	malignant_27
ACTTATCCACAGCTGC-1_pos	malignant_27
ACTTTCATCACTCACC-1_pos	malignant_27
AGGAAATCAAGAGAGA-1_pos	malignant_27
AGTACTGAGATCCCAT-1_pos	malignant_27
AGTGCCGGTCGTTATG-1_pos	malignant_27
ATGCCTCAGAAGGTAG-1_pos	malignant_27
ATTATCCTCCTGTAGA-1_pos	malignant_27
ATTCGTTAGAGGGTCT-1_pos	malignant_27
CACCAAATCCAAGCTA-1_pos	malignant_27
CACTGGGTCTCAACCC-1_pos	malignant_27
CAGATCATCATTCACT-1_pos	malignant_27
CAGGTATTCGCTAAAC-1_pos	malignant_27
CATGCGGTCTCCAATT-1_pos	malignant_27
CCCGAAGGTAGCTTTG-1_pos	malignant_27
CCTCTCCGTCCGAAAG-1_pos	malignant_27
CTAACCCCAATCTGCA-1_pos	malignant_27
CTCCCTCGTCGTACTA-1_pos	malignant_27
CTGAGCGCAATCGTCA-1_pos	malignant_27
CTTAGGACAGCACACC-1_pos	malignant_27
GAGGCAAGTCCAATCA-1_pos	malignant_27
GATAGCTTCTAATTCC-1_pos	malignant_27
GCATGATTCCCTGGTT-1_pos	malignant_27
GCCCGAAAGTTGGGAC-1_pos	malignant_27
GCTGCAGAGGCCCGTT-1_pos	malignant_27
GTCTGTCAGCCTCAAT-1_pos	malignant_27
TACGGGCTCATGAGTC-1_pos	malignant_27
TATCTGTGTGATGGCA-1_pos	malignant_27
TCAGGTATCGAACCAT-1_pos	malignant_27
TCAGTTTCATCACGGC-1_pos	malignant_27
TCATTACGTTTGAACC-1_pos	malignant_27
TCTTAGTGTGTTATCG-1_pos	malignant_27
TGCTCGTCAAAGGCAC-1_pos	malignant_27
TGCTTCGAGTAGCCAG-1_pos	malignant_27
TGCTTGCGTTCCGGTG-1_pos	malignant_27
TGGAGAGTCATACGGT-1_pos	malignant_27
TGGGCTGCAGCTGAGA-1_pos	malignant_27
TGGGTTATCGTTATCT-1_pos	malignant_27
TGTAGACTCAGGTGTT-1_pos	malignant_27
TTCACCGTCTGTGCTC-1_pos	malignant_27
TTGAACGAGCCTGACC-1_pos	malignant_27
TTGAGTGCACTTGACA-1_pos	malignant_27
TTGCCTGGTAGTACGG-1_pos	malignant_27
AAACCCAGTCTTTATC-1_pos	malignant_3
AAAGGGCGTGCCCGTA-1_pos	malignant_3
AAAGTGAAGGGAGTTC-1_pos	malignant_3
AACAACCAGGACTATA-1_pos	malignant_3
AACCACAAGTTGGAGC-1_pos	malignant_3
AACCATGGTCTCAGAT-1_pos	malignant_3
AACGTCACACACCTAA-1_pos	malignant_3
AAGACAAAGTCTACCA-1_pos	malignant_3
AAGGAATTCAGGACAG-1_pos	malignant_3
AAGTCGTTCTGGTGGC-1_pos	malignant_3
AAGTGAAGTCAAGCCC-1_pos	malignant_3
AATAGAGGTGTGTGGA-1_pos	malignant_3
AATGAAGGTATCATGC-1_pos	malignant_3
ACAAGCTAGGGCAATC-1_pos	malignant_3
ACAAGCTGTACCGTCG-1_pos	malignant_3
ACACCAACAACACTAC-1_pos	malignant_3
ACACGCGCAACCGTGC-1_pos	malignant_3
ACAGCCGGTTGGTACT-1_pos	malignant_3
ACAGGGAGTAGCGTAG-1_pos	malignant_3
ACAGGGATCCATTGTT-1_pos	malignant_3
ACATCCCTCCTTCTTC-1_pos	malignant_3
ACATGCAAGTAAGAGG-1_pos	malignant_3
ACCATTTCAACACAGG-1_pos	malignant_3
ACCCAAAAGAATCGCG-1_pos	malignant_3
ACCCAAAAGGCTAACG-1_pos	malignant_3
ACCCTCAAGCCGGATA-1_pos	malignant_3
ACCCTTGAGCATGATA-1_pos	malignant_3
ACCTGAACATCCAACA-1_pos	malignant_3
ACGATCAGTGTGCTTA-1_pos	malignant_3
ACGCACGTCCATCACC-1_pos	malignant_3
ACGTAACTCAGCGCGT-1_pos	malignant_3
ACGTACAAGAAGGCTC-1_pos	malignant_3
ACGTAGTCAGGCGAAT-1_pos	malignant_3
ACGTTCCAGGCTCTAT-1_pos	malignant_3
ACTATCTGTCGTATGT-1_pos	malignant_3
ACTGCAAGTTCGTTCC-1_pos	malignant_3
ACTTAGGGTATTGCCA-1_pos	malignant_3
ACTTATCGTTGGACTT-1_pos	malignant_3
ACTTCCGCAAGTCGTT-1_pos	malignant_3
ACTTTCATCTGTCCGT-1_pos	malignant_3
AGAAATGAGGTCTGGA-1_pos	malignant_3
AGAAGCGAGGGAGGCA-1_pos	malignant_3
AGACCATTCGTGTTCC-1_pos	malignant_3
AGAGAGCCATCATCCC-1_pos	malignant_3
AGATCCACACGGTGAA-1_pos	malignant_3
AGATGCTGTAGCGTTT-1_pos	malignant_3
AGCCACGAGGTAAGAG-1_pos	malignant_3
AGCCACGGTTCAGGTT-1_pos	malignant_3
AGCCAGCGTGGGTCAA-1_pos	malignant_3
AGCGCCAGTGCGCTCA-1_pos	malignant_3
AGCGTATAGCGCCTCA-1_pos	malignant_3
AGCGTATTCGACGATT-1_pos	malignant_3
AGCTCAACAACAAGAT-1_pos	malignant_3
AGCTCAATCTTACTGT-1_pos	malignant_3
AGGAGGTAGCATCAGG-1_pos	malignant_3
AGGTAGGAGCTCGGCT-1_pos	malignant_3
AGGTCATTCTCAGGCG-1_pos	malignant_3
AGGTTACAGCAGCAGT-1_pos	malignant_3
AGTAACCAGGAAGTGA-1_pos	malignant_3
AGTAACCAGTCAGAGC-1_pos	malignant_3
AGTAGTCGTAAGCAAT-1_pos	malignant_3
AGTAGTCGTCACGTGC-1_pos	malignant_3
AGTCAACGTTACCTGA-1_pos	malignant_3
AGTCACATCCCATTTA-1_pos	malignant_3
AGTCATGTCCCACAGG-1_pos	malignant_3
AGTGATCAGCATGAAT-1_pos	malignant_3
AGTGATCCAAGCGGAT-1_pos	malignant_3
AGTGCCGAGAAGCTCG-1_pos	malignant_3
AGTTAGCAGCTGAAAT-1_pos	malignant_3
AGTTAGCTCTAATTCC-1_pos	malignant_3
ATCACAGAGCGCCTAC-1_pos	malignant_3
ATCACTTTCACACGAT-1_pos	malignant_3
ATCACTTTCGAGCCTG-1_pos	malignant_3
ATCAGGTGTCAGCTTA-1_pos	malignant_3
ATCATTCTCGGTCGAC-1_pos	malignant_3
ATCCATTCATGTGACT-1_pos	malignant_3
ATCCGTCAGTTGCCCG-1_pos	malignant_3
ATCCTATTCACTTCTA-1_pos	malignant_3
ATCGGATTCAACCGAT-1_pos	malignant_3
ATCGGCGAGGGCCAAT-1_pos	malignant_3
ATGCCTCCACCCGTAG-1_pos	malignant_3
ATGGATCCATCGCTCT-1_pos	malignant_3
ATGTCTTCACAGACGA-1_pos	malignant_3
ATTCAGGGTGCCCAGT-1_pos	malignant_3
ATTCCCGTCGCGGTAC-1_pos	malignant_3
CAAAGAATCTAGTCAG-1_pos	malignant_3
CAACAGTTCCTGTTGC-1_pos	malignant_3
CAACCAACACAGTCAT-1_pos	malignant_3
CAACGGCAGTAAACGT-1_pos	malignant_3
CAACGGCTCCAGCAAT-1_pos	malignant_3
CAAGAGGTCACACGAT-1_pos	malignant_3
CAATACGAGTACTGTC-1_pos	malignant_3
CAATCGAAGCCTGCCA-1_pos	malignant_3
CACAACAGTCATAACC-1_pos	malignant_3
CACACAAGTCCAACGC-1_pos	malignant_3
CACAGATCAAATAAGC-1_pos	malignant_3
CACAGATCAAGAGTTA-1_pos	malignant_3
CACAGATCACCATTCC-1_pos	malignant_3
CACCGTTCAGTTAGAA-1_pos	malignant_3
CACTGGGGTGAACTAA-1_pos	malignant_3
CAGATACAGTATGTAG-1_pos	malignant_3
CAGATCATCACGTAGT-1_pos	malignant_3
CAGCAATCAGTTAGAA-1_pos	malignant_3
CAGGCCAGTCCCACGA-1_pos	malignant_3
CAGTGCGTCCAAGAGG-1_pos	malignant_3
CAGTTAGCATGTCAGT-1_pos	malignant_3
CATACAGTCATCCTAT-1_pos	malignant_3
CATACCCAGCTAGAGC-1_pos	malignant_3
CATCCGTAGTTTGGCT-1_pos	malignant_3
CATCCGTCAAGGATGC-1_pos	malignant_3
CATCCGTCAGCAAGAC-1_pos	malignant_3
CATCCGTGTGACGTCC-1_pos	malignant_3
CATCGGGAGCATATGA-1_pos	malignant_3
CATGCAAAGACTGGGT-1_pos	malignant_3
CATGCAACATAGAAAC-1_pos	malignant_3
CATGGTACATAGGCGA-1_pos	malignant_3
CATTCATGTTAAGACA-1_pos	malignant_3
CATTGAGGTCTTCGAA-1_pos	malignant_3
CATTGAGGTGCTGTCG-1_pos	malignant_3
CATTGAGTCCAGGACC-1_pos	malignant_3
CCAAGCGAGTTGAATG-1_pos	malignant_3
CCAATGAGTTGGGACA-1_pos	malignant_3
CCACAAAAGCGATCGA-1_pos	malignant_3
CCACAAACATTGAGGG-1_pos	malignant_3
CCATCACGTCCTCCAT-1_pos	malignant_3
CCCAACTAGGTTATAG-1_pos	malignant_3
CCCAACTGTCCCGTGA-1_pos	malignant_3
CCCTCTCAGGTCACAG-1_pos	malignant_3
CCCTCTCCATCCGTTC-1_pos	malignant_3
CCGATCTGTGATTCAC-1_pos	malignant_3
CCGCAAGCACTCATAG-1_pos	malignant_3
CCGCAAGGTTGTGTAC-1_pos	malignant_3
CCGGACAAGCTAGAGC-1_pos	malignant_3
CCGGACAAGCTTTCCC-1_pos	malignant_3
CCGGTAGAGGCATTTC-1_pos	malignant_3
CCGTAGGTCGGAGATG-1_pos	malignant_3
CCGTAGGTCTCGCGTT-1_pos	malignant_3
CCGTTCAAGTTCCGTA-1_pos	malignant_3
CCTACGTGTCACTACA-1_pos	malignant_3
CCTACGTGTTCGGTAT-1_pos	malignant_3
CCTCAGTGTCAATCTG-1_pos	malignant_3
CGACAGCAGAGTTGAT-1_pos	malignant_3
CGAGGAAAGAACGCGT-1_pos	malignant_3
CGAGTTAGTCTCACGG-1_pos	malignant_3
CGCAGGTCACCAGGTC-1_pos	malignant_3
CGCATAAAGCAAACAT-1_pos	malignant_3
CGCCATTAGCGACTAG-1_pos	malignant_3
CGGAACCGTGGGTATG-1_pos	malignant_3
CGGAGAATCGCTCATC-1_pos	malignant_3
CGGGCATAGAGCAGTC-1_pos	malignant_3
CGGGTCATCCGTGCGA-1_pos	malignant_3
CGGGTGTTCGCAGTCG-1_pos	malignant_3
CGTAGTATCTAGACCA-1_pos	malignant_3
CGTCAAACAGTTGCGC-1_pos	malignant_3
CGTGTCTTCAAGCCTA-1_pos	malignant_3
CGTTCTGAGCCTAGGA-1_pos	malignant_3
CGTTCTGCACTCTAGA-1_pos	malignant_3
CTAACCCGTACAGTAA-1_pos	malignant_3
CTAACTTAGTCCGCGT-1_pos	malignant_3
CTACATTAGACTGAGC-1_pos	malignant_3
CTACCCAAGGCTCAAG-1_pos	malignant_3
CTACTATCACTTCTCG-1_pos	malignant_3
CTATCTATCTGGTGCG-1_pos	malignant_3
CTCAGGGTCTAACACG-1_pos	malignant_3
CTCATCGGTTTAGAGA-1_pos	malignant_3
CTCTCAGTCCGAAATC-1_pos	malignant_3
CTGAATGTCGAAACAA-1_pos	malignant_3
CTGCCATCAACAGTGG-1_pos	malignant_3
CTGCCATGTTGCTCGG-1_pos	malignant_3
CTGTACCTCCGGACTG-1_pos	malignant_3
CTGTCGTCAGTGACCC-1_pos	malignant_3
CTTCGGTAGTCATGAA-1_pos	malignant_3
CTTGATTTCGGACTGC-1_pos	malignant_3
CTTTCGGTCTGGCCTT-1_pos	malignant_3
GAAACCTGTTACACAC-1_pos	malignant_3
GAAGCCCAGGGAGGAC-1_pos	malignant_3
GAAGGGTAGTTTGGCT-1_pos	malignant_3
GACCCAGCAAAGAACT-1_pos	malignant_3
GACCCTTGTACCAGAG-1_pos	malignant_3
GACTATGGTCCAAGAG-1_pos	malignant_3
GAGACCCTCACCCTCA-1_pos	malignant_3
GAGAGGTCAAGGTCGA-1_pos	malignant_3
GAGATGGAGAGTCTTC-1_pos	malignant_3
GAGGCAATCCGAAATC-1_pos	malignant_3
GAGGGATTCATACGGT-1_pos	malignant_3
GAGGGTACAACCGTGC-1_pos	malignant_3
GAGGGTACATCTATCT-1_pos	malignant_3
GAGTCTAAGTAGCAAT-1_pos	malignant_3
GAGTGAGGTAGTGGCA-1_pos	malignant_3
GAGTGAGGTCCCTCAT-1_pos	malignant_3
GAGTTACAGGCGCTTC-1_pos	malignant_3
GAGTTACGTGTCTTAG-1_pos	malignant_3
GAGTTTGTCCTTATCA-1_pos	malignant_3
GATAGAAAGAGCCCAA-1_pos	malignant_3
GATAGAATCCGAAGGA-1_pos	malignant_3
GATCAGTCAACTAGAA-1_pos	malignant_3
GATCCCTTCACTGATG-1_pos	malignant_3
GATGAGGGTCTGTAAC-1_pos	malignant_3
GATGTTGCAATATCCG-1_pos	malignant_3
GATTTCTAGGGAGATA-1_pos	malignant_3
GATTTCTAGTTGCCCG-1_pos	malignant_3
GCAACCGAGATTACCC-1_pos	malignant_3
GCACGGTCAGCGAACA-1_pos	malignant_3
GCACGGTCAGTGTACT-1_pos	malignant_3
GCAGCCAAGACATGCG-1_pos	malignant_3
GCAGGCTAGCTGACAG-1_pos	malignant_3
GCAGTTAAGACCAAGC-1_pos	malignant_3
GCATCGGAGCGTCTGC-1_pos	malignant_3
GCCAGCATCAACCGAT-1_pos	malignant_3
GCCAGTGTCTTTGCAT-1_pos	malignant_3
GCCATGGAGTCGGCAA-1_pos	malignant_3
GCCCAGACAGCACAGA-1_pos	malignant_3
GCCCAGATCCTACGAA-1_pos	malignant_3
GCGAGAAAGATGCAGC-1_pos	malignant_3
GCGAGAATCCGTATGA-1_pos	malignant_3
GCGATCGCACCAGTTA-1_pos	malignant_3
GCGGATCAGTACTGGG-1_pos	malignant_3
GCGTGCAGTGGAGGTT-1_pos	malignant_3
GCTACAATCACCATAG-1_pos	malignant_3
GCTACCTCAGTGTATC-1_pos	malignant_3
GCTGCAGAGCAACAGC-1_pos	malignant_3
GCTGGGTCAACTGTGT-1_pos	malignant_3
GGAGAACAGCTGTTCA-1_pos	malignant_3
GGATGTTTCGCGGACT-1_pos	malignant_3
GGCGTCATCCAGCAAT-1_pos	malignant_3
GGCGTCATCGTGCGAC-1_pos	malignant_3
GGGAAGTAGATGAATC-1_pos	malignant_3
GGGAAGTAGCCATATC-1_pos	malignant_3
GGGATGAAGTAGCATA-1_pos	malignant_3
GGGTCTGTCTGTGCGG-1_pos	malignant_3
GGTAGAGTCATACGAC-1_pos	malignant_3
GGTGTTACAGATTTCG-1_pos	malignant_3
GGTTGTATCATACGGT-1_pos	malignant_3
GTAACACTCATCGCTC-1_pos	malignant_3
GTAACCACACCGCTGA-1_pos	malignant_3
GTAGCTATCCTATGGA-1_pos	malignant_3
GTAGTACAGCGCCCAT-1_pos	malignant_3
GTCACTCAGTCACAGG-1_pos	malignant_3
GTCAGCGGTCGCATGC-1_pos	malignant_3
GTCATGAAGGTACATA-1_pos	malignant_3
GTCATTTCAAACTCTG-1_pos	malignant_3
GTGACGCCAACTGGTT-1_pos	malignant_3
GTGAGTTGTTGATGTC-1_pos	malignant_3
GTGATGTGTCTTCCGT-1_pos	malignant_3
GTGGCGTTCTTCCACG-1_pos	malignant_3
GTGGGAACACACCTGG-1_pos	malignant_3
GTGGTTAGTCACCACG-1_pos	malignant_3
GTGTTCCTCACCATCC-1_pos	malignant_3
GTTATGGTCTGCATAG-1_pos	malignant_3
GTTCATTCACAGCTGC-1_pos	malignant_3
GTTCCGTTCCCGAATA-1_pos	malignant_3
GTTGCTCCAATCACGT-1_pos	malignant_3
GTTGTCCAGTGGACTG-1_pos	malignant_3
TAACGACCACTAGGCC-1_pos	malignant_3
TAAGCACCATAATGCC-1_pos	malignant_3
TAAGCACGTCCGAAGA-1_pos	malignant_3
TACAACGGTATGTCAC-1_pos	malignant_3
TACACCCGTATAATGG-1_pos	malignant_3
TACATTCTCGGCCCAA-1_pos	malignant_3
TACCTCGAGTATTGCC-1_pos	malignant_3
TACCTCGGTACAATAG-1_pos	malignant_3
TACCTCGTCAGATGCT-1_pos	malignant_3
TACGGTATCTAATTCC-1_pos	malignant_3
TACTTACCAGGGACTA-1_pos	malignant_3
TACTTCATCGACCAAT-1_pos	malignant_3
TAGACCAGTGTCATCA-1_pos	malignant_3
TAGATCGCAAAGGATT-1_pos	malignant_3
TAGATCGCATGGGTTT-1_pos	malignant_3
TAGGAGGCAATTCTTC-1_pos	malignant_3
TAGGAGGCATTCTCCG-1_pos	malignant_3
TAGGGTTCACACAGCC-1_pos	malignant_3
TAGGTTGCACCATATG-1_pos	malignant_3
TAGGTTGGTCAGTCTA-1_pos	malignant_3
TAGTGCAAGTTGAAGT-1_pos	malignant_3
TATCAGGGTAATGCTC-1_pos	malignant_3
TATCAGGTCGGTCACG-1_pos	malignant_3
TATCCTATCTCTTAAC-1_pos	malignant_3
TATTGCTGTTAGCGGA-1_pos	malignant_3
TATTGCTTCAGAGTGG-1_pos	malignant_3
TATTGGGTCTAACACG-1_pos	malignant_3
TATTTCGAGTCACTAC-1_pos	malignant_3
TATTTCGGTTGTTGCA-1_pos	malignant_3
TCACAAGCAGCACCCA-1_pos	malignant_3
TCACATTCAGACTGCC-1_pos	malignant_3
TCACATTGTATCCCAA-1_pos	malignant_3
TCACTATGTTTCGTAG-1_pos	malignant_3
TCAGCAATCGGCTGTG-1_pos	malignant_3
TCAGGTATCTGTCCGT-1_pos	malignant_3
TCATACTAGTCCCTAA-1_pos	malignant_3
TCCACGTTCCGCGAGT-1_pos	malignant_3
TCCCAGTTCATTGAGC-1_pos	malignant_3
TCCGAAAGTAGGTAGC-1_pos	malignant_3
TCCGGGAGTTACGATC-1_pos	malignant_3
TCCGTGTCACGCACCA-1_pos	malignant_3
TCCTCGACAGATGCGA-1_pos	malignant_3
TCCTGCACACGGGCTT-1_pos	malignant_3
TCGCACTTCAACCGAT-1_pos	malignant_3
TCGCAGGCACGGTGCT-1_pos	malignant_3
TCGCAGGTCGGAGATG-1_pos	malignant_3
TCGCTCAGTCTCACAA-1_pos	malignant_3
TCGCTCATCTGGTGCG-1_pos	malignant_3
TCGCTTGGTCATCCCT-1_pos	malignant_3
TCGCTTGGTGGTTCTA-1_pos	malignant_3
TCGGGCATCCTCAGAA-1_pos	malignant_3
TCGGGTGAGCCTCCAG-1_pos	malignant_3
TCGGGTGCAAGTGTCT-1_pos	malignant_3
TCGTAGAAGTAAACGT-1_pos	malignant_3
TCGTGCTGTCTCTCCA-1_pos	malignant_3
TCTACCGGTATTGAGA-1_pos	malignant_3
TCTATACAGCCATTTG-1_pos	malignant_3
TCTCAGCGTAATTGGA-1_pos	malignant_3
TCTCAGCGTTTACCAG-1_pos	malignant_3
TCTCCGATCTTGATTC-1_pos	malignant_3
TCTGGCTAGGCAGGGA-1_pos	malignant_3
TCTGGCTCAGCATACT-1_pos	malignant_3
TGAGCGCGTCCAAAGG-1_pos	malignant_3
TGAGTCATCGAACTCA-1_pos	malignant_3
TGATCTTTCACAATGC-1_pos	malignant_3
TGATGCAGTCGTAATC-1_pos	malignant_3
TGCCGAGCAAGCTACT-1_pos	malignant_3
TGCTCCAAGCAGCCCT-1_pos	malignant_3
TGGAACTGTAACTTCG-1_pos	malignant_3
TGGAACTGTACTAGCT-1_pos	malignant_3
TGGAGAGGTACAGCGA-1_pos	malignant_3
TGGAGGACATGGATCT-1_pos	malignant_3
TGGATCAAGAACCGCA-1_pos	malignant_3
TGGATCAAGCTCCGAC-1_pos	malignant_3
TGGCGTGTCTATCGGA-1_pos	malignant_3
TGGGAGAGTATTGCCA-1_pos	malignant_3
TGGGATTAGGACGCAT-1_pos	malignant_3
TGGGCGTAGGTAGTCG-1_pos	malignant_3
TGGGCTGCAACCCTAA-1_pos	malignant_3
TGGGCTGTCATTGTGG-1_pos	malignant_3
TGGTACAGTTGGAGGT-1_pos	malignant_3
TGGTGATCATCACGGC-1_pos	malignant_3
TGTAACGGTTGCAAGG-1_pos	malignant_3
TGTGATGAGCCTTTCC-1_pos	malignant_3
TGTGCGGCAAGTAGTA-1_pos	malignant_3
TGTGCGGTCCCATAGA-1_pos	malignant_3
TGTGGCGCAAGGACAC-1_pos	malignant_3
TGTGGCGCAGAGTCAG-1_pos	malignant_3
TGTGTGACATAGGTTC-1_pos	malignant_3
TTACCATTCCCTCAAC-1_pos	malignant_3
TTACCGCCATGGAATA-1_pos	malignant_3
TTACGCCCACCTCGTT-1_pos	malignant_3
TTACGCCCACGGGCTT-1_pos	malignant_3
TTCACGCAGTGAGGTC-1_pos	malignant_3
TTCACGCCAGCATACT-1_pos	malignant_3
TTCAGGATCCTTGAAG-1_pos	malignant_3
TTCATGTGTTCGTTCC-1_pos	malignant_3
TTCCAATAGCGTTACT-1_pos	malignant_3
TTCCAATGTACTAACC-1_pos	malignant_3
TTCCACGGTCCCTGAG-1_pos	malignant_3
TTCCTCTGTTAGAAGT-1_pos	malignant_3
TTCGATTCAGGCACTC-1_pos	malignant_3
TTCGGTCCACAGCTGC-1_pos	malignant_3
TTCTAACCAATTGCCA-1_pos	malignant_3
TTGAGTGAGAAGATCT-1_pos	malignant_3
TTGCATTCATATCTGG-1_pos	malignant_3
TTGCCTGGTGACTATC-1_pos	malignant_3
TTGCGTCCACACCGAC-1_pos	malignant_3
TTGCTGCTCATGAAAG-1_pos	malignant_3
TTGGGATCAATTCGTG-1_pos	malignant_3
TTGGGCGAGATAACAC-1_pos	malignant_3
TTGGGCGGTCGATTAC-1_pos	malignant_3
TTTACGTCACTCTCGT-1_pos	malignant_3
TTTCCTCAGCAGTAAT-1_pos	malignant_3
TTTCGATAGATACAGT-1_pos	malignant_3
TTTGACTAGTCAATCC-1_pos	malignant_3
TTTGGAGGTCATAGTC-1_pos	malignant_3
TTTGGTTAGGTAACTA-1_pos	malignant_3
AAACCCAGTGACTCGC-1_pos	malignant_31
AAACCCATCCGGACGT-1_pos	malignant_31
AAATGGACATGGGTTT-1_pos	malignant_31
AAGTTCGTCTTCACGC-1_pos	malignant_31
ACCCAAAGTAGCTGAG-1_pos	malignant_31
ACGGTCGTCCCGAAAT-1_pos	malignant_31
ACTTTGTAGTCCGCGT-1_pos	malignant_31
AGCTACACAACACAGG-1_pos	malignant_31
AGGTGTTGTGCACATT-1_pos	malignant_31
AGTAGTCTCGGCGATC-1_pos	malignant_31
CACAACAGTCAGGTAG-1_pos	malignant_31
CACTTCGTCGTCACCT-1_pos	malignant_31
CAGGGCTCATCACAGT-1_pos	malignant_31
CATACAGGTCCCTAAA-1_pos	malignant_31
CATGCCTGTGTTACTG-1_pos	malignant_31
CATTGTTTCGTAGAGG-1_pos	malignant_31
CCCGAAGAGCGAGTAC-1_pos	malignant_31
CGAGGAAGTTCCGCAG-1_pos	malignant_31
CGGAGAATCAGGTGTT-1_pos	malignant_31
CTACGGGCACCGCTGA-1_pos	malignant_31
CTACTATGTGGAACCA-1_pos	malignant_31
CTCCATGAGAGAGGTA-1_pos	malignant_31
CTGGACGCAAGGTCAG-1_pos	malignant_31
GAAATGAAGTGTCATC-1_pos	malignant_31
GACACGCAGGATGGCT-1_pos	malignant_31
GAGTTTGAGTTTGGCT-1_pos	malignant_31
GATCATGCATGGGTCC-1_pos	malignant_31
GCCCAGAGTGTCTTAG-1_pos	malignant_31
GGGACAATCGAGCCTG-1_pos	malignant_31
GTATTTCTCCTTCTTC-1_pos	malignant_31
GTCTTTAGTCTGTCAA-1_pos	malignant_31
GTGAGTTCACATAGCT-1_pos	malignant_31
TAACGACCACTTGTGA-1_pos	malignant_31
TAATCTCTCGAAACAA-1_pos	malignant_31
TACGGTAAGATAGGGA-1_pos	malignant_31
TGAGCGCCACAGCGCT-1_pos	malignant_31
TGATGCAGTGCTATTG-1_pos	malignant_31
TGATTCTAGACTCAAA-1_pos	malignant_31
TGCGATACACTGTCCT-1_pos	malignant_31
TGGAGGACAATCTCGA-1_pos	malignant_31
TGGGATTTCGCTACAA-1_pos	malignant_31
TTTGGTTGTTCTCGTC-1_pos	malignant_31
AAAGGGCCAGAGCGTA-1_pos	malignant_32
AACAAGACATACTGTG-1_pos	malignant_32
AATAGAGGTGATTAGA-1_pos	malignant_32
AATTCCTGTGCCGGTT-1_pos	malignant_32
ACAGAAACAGATTCGT-1_pos	malignant_32
ACATTTCTCATCTGTT-1_pos	malignant_32
ACGATCACAGCGAACA-1_pos	malignant_32
ACTCTCGTCATCGACA-1_pos	malignant_32
ACTGTGAGTCCGTACG-1_pos	malignant_32
AGAGAATCAGCTACCG-1_pos	malignant_32
AGGAATAGTACGACAG-1_pos	malignant_32
ATACTTCCAGGATCTT-1_pos	malignant_32
ATGAGTCGTCTACACA-1_pos	malignant_32
CAGGGCTCATGGATCT-1_pos	malignant_32
CATCAAGCAATTGCTG-1_pos	malignant_32
CATTGCCTCACCGGGT-1_pos	malignant_32
CCATAAGAGAGCAACC-1_pos	malignant_32
CCGCAAGCAACCACAT-1_pos	malignant_32
CCTGCATTCCCATACC-1_pos	malignant_32
CTCAATTTCTCCGAAA-1_pos	malignant_32
CTCCATGAGGACATCG-1_pos	malignant_32
CTCCCAACACGTCTCT-1_pos	malignant_32
CTCCCAACAGGCATGA-1_pos	malignant_32
GAAGAATTCGTCTAAG-1_pos	malignant_32
GACAGCCGTCGATGCC-1_pos	malignant_32
GCGGATCGTACGATTC-1_pos	malignant_32
GCGTTTCTCCGAGTGC-1_pos	malignant_32
GCTTTCGTCTTTGGAG-1_pos	malignant_32
GGGACTCCAAAGGGTC-1_pos	malignant_32
GTAGCTATCTCGTCAC-1_pos	malignant_32
GTGCAGCCAAGCTGCC-1_pos	malignant_32
GTTGTGATCTTGGCTC-1_pos	malignant_32
TAAGTCGGTCGAGCAA-1_pos	malignant_32
TATCAGGAGTGTACAA-1_pos	malignant_32
TATCTTGTCCCTTCCC-1_pos	malignant_32
TATGTTCAGAGCATAT-1_pos	malignant_32
TCTCAGCAGAAGTATC-1_pos	malignant_32
TCTCCGAGTATCTCTT-1_pos	malignant_32
TCTCTGGCATCACGGC-1_pos	malignant_32
TGAACGTGTCTGCGCA-1_pos	malignant_32
TGCGGCAGTGAGTAAT-1_pos	malignant_32
TTCGCTGGTTGTTGAC-1_pos	malignant_32
TTCTGTATCGGACGTC-1_pos	malignant_32
TTGGGCGGTGGACCAA-1_pos	malignant_32
AACAAAGAGCTTGTTG-1_pos	malignant_34
ACAAAGAAGAGTCTGG-1_pos	malignant_34
AGGCATTCAACGCATT-1_pos	malignant_34
AGTCATGTCTGCATAG-1_pos	malignant_34
ATCGCCTCATTGAAAG-1_pos	malignant_34
CCGGTAGGTGCCTTCT-1_pos	malignant_34
CGAGGCTCAATGACCT-1_pos	malignant_34
CTGTGGGCATCTCAAG-1_pos	malignant_34
CTTACCGCAGAGGCAT-1_pos	malignant_34
CTTCCGATCTGTGCTC-1_pos	malignant_34
GAGACCCCAGAGTGAC-1_pos	malignant_34
GAGACTTAGGCGTCCT-1_pos	malignant_34
GCACGGTAGCTCGACC-1_pos	malignant_34
GCTGAATCAGGTCAAG-1_pos	malignant_34
GGTCACGCACGACAAG-1_pos	malignant_34
ACTATGGTCTCAGGCG-1_pos	malignant_38
ACTATTCCACCGGTCA-1_pos	malignant_38
AGACTCATCAAGGTGG-1_pos	malignant_38
ATGGTTGGTGGACCAA-1_pos	malignant_38
CCTTTGGGTCGCGTTG-1_pos	malignant_38
CTTCGGTTCGGAGTAG-1_pos	malignant_38
CTTTCAACATTCCTCG-1_pos	malignant_38
GGGTGTCTCCGGGACT-1_pos	malignant_38
GTCATCCCACCGGCTA-1_pos	malignant_38
GTGCTGGGTATGCTAC-1_pos	malignant_38
TCCATCGGTTGTAAAG-1_pos	malignant_38
TTAGTCTGTCTACGTA-1_pos	malignant_38
TTTATGCAGCATACTC-1_pos	malignant_38
TTTGGTTTCAAACCTG-1_pos	malignant_38
ACACAGTAGTCTGCGC-1_pos	malignant_44
ACACGCGCAGCAGATG-1_pos	malignant_44
ACTGATGAGATGACCG-1_pos	malignant_44
AGGTTGTGTTGCGGCT-1_pos	malignant_44
ATGGTTGGTCACCCTT-1_pos	malignant_44
CAGCAATGTTGGCTAT-1_pos	malignant_44
CTCCATGGTGCTCGTG-1_pos	malignant_44
CTTAGGAAGCTCGCAC-1_pos	malignant_44
GAAGCCCCAACGTTAC-1_pos	malignant_44
GACCTTCCAGAGCCCT-1_pos	malignant_44
GCCATGGAGTACGAGC-1_pos	malignant_44
GCTACCTAGCCAGACA-1_pos	malignant_44
GGGTATTTCCTACAAG-1_pos	malignant_44
GTGGCGTTCTATCGCC-1_pos	malignant_44
TATCTTGAGCCGATCC-1_pos	malignant_44
TGATCAGTCAAGAGGC-1_pos	malignant_44
TGCACGGTCACCCTTG-1_pos	malignant_44
TGTTGAGGTATCTCGA-1_pos	malignant_44
TTTACCACAGAGATTA-1_pos	malignant_44
AACGAAAGTTTCACTT-1_pos	malignant_52
AGTGATCGTAATCAGA-1_pos	malignant_52
CAGCAATCATCCAATG-1_pos	malignant_52
CAGCAGCCAGCATTGT-1_pos	malignant_52
CATTGCCCACTTCAGA-1_pos	malignant_52
CTTAGGACATGGCTGC-1_pos	malignant_52
CTTCGGTTCTCCGATC-1_pos	malignant_52
CTTCTCTCAGCAGAAC-1_pos	malignant_52
GATGTTGCACACAGCC-1_pos	malignant_52
GTTCCGTTCGCTCTAC-1_pos	malignant_52
TCAGGTATCTACCCAC-1_pos	malignant_52
TCATGGACACAACCGC-1_pos	malignant_52
TCTTTGATCAAAGGAT-1_pos	malignant_52
AATCACGGTTCTTGTT-1_pos	malignant_54
ACATCGATCGAGAACG-1_pos	malignant_54
AGACACTCACCACATA-1_pos	malignant_54
AGCCAATAGTGGTTGG-1_pos	malignant_54
AGCCAGCTCACGATCA-1_pos	malignant_54
CAACAGTTCGGTAGGA-1_pos	malignant_54
CCTATCGTCACATCAG-1_pos	malignant_54
CCTTCAGGTGTTCAGT-1_pos	malignant_54
CGCCATTAGGATGGCT-1_pos	malignant_54
CGTAAGTAGAGGTTTA-1_pos	malignant_54
GACTTCCTCAAGGTGG-1_pos	malignant_54
GAGATGGCATGAATAG-1_pos	malignant_54
GCATCGGAGAGTACCG-1_pos	malignant_54
GTAGATCCAGCACGAA-1_pos	malignant_54
TGGGAAGGTCGGCTAC-1_pos	malignant_54
TGTTCTACAACCCTCT-1_pos	malignant_54
TTATTGCTCAAGGAGC-1_pos	malignant_54
AACAAAGGTTAAAGTG-1_pos	malignant_6
AACGTCAGTAGCTTTG-1_pos	malignant_6
ACACAGTCACGTCATA-1_pos	malignant_6
CACTGTCGTTAACCTG-1_pos	malignant_6
CATGCGGTCGGTTCAA-1_pos	malignant_6
CATTTCAAGGAGTCTG-1_pos	malignant_6
CTTGAGATCCACATAG-1_pos	malignant_6
GAACACTTCCCGAATA-1_pos	malignant_6
GCATCTCAGGAGCAAA-1_pos	malignant_6
GGAAGTGGTTGTCTAG-1_pos	malignant_6
GGGACTCCAGCAATTC-1_pos	malignant_6
GTACAACTCCCATTCG-1_pos	malignant_6
GTAGAAATCCTGGTCT-1_pos	malignant_6
GTGCACGCATCGGAGA-1_pos	malignant_6
TACTTCAAGTCGCCCA-1_pos	malignant_6
TATCAGGCAGCCCACA-1_pos	malignant_6
TGACAGTAGTACAACA-1_pos	malignant_6
TGAGCATAGGTGCCTC-1_pos	malignant_6
TGTGAGTAGTCATTGC-1_pos	malignant_6
TTCTCTCTCACAGAGG-1_pos	malignant_6
TTGCGTCCAGCTACAT-1_pos	malignant_6
TTGGATGTCTCGCTCA-1_pos	malignant_6
AAAGGATCAAATCCCA-1_pos	malignant_62
ACATGCAAGTCATAGA-1_pos	malignant_62
ACCCTCAAGTCCCGAC-1_pos	malignant_62
ACGATCAAGTTCGCAT-1_pos	malignant_62
AGAGCCCCAATAGGAT-1_pos	malignant_62
AGGAATATCAGGTAAA-1_pos	malignant_62
AGGGCTCCAGTAACGG-1_pos	malignant_62
ATCAGGTAGCACCGTC-1_pos	malignant_62
ATGGGAGTCGGCATTA-1_pos	malignant_62
ATTCCCGTCCACTTCG-1_pos	malignant_62
CACAGATAGGTAATCA-1_pos	malignant_62
CAGTTAGAGTGCAGGT-1_pos	malignant_62
CCGGTAGTCATACAGC-1_pos	malignant_62
CGAAGGATCACGATCA-1_pos	malignant_62
CGGAACCTCACTCCGT-1_pos	malignant_62
CGTCAAATCTCTAGGA-1_pos	malignant_62
CTAGGTATCTACCCAC-1_pos	malignant_62
CTATCCGTCAAGCCGC-1_pos	malignant_62
CTCTGGTCACATATGC-1_pos	malignant_62
CTGCAGGGTCGATTAC-1_pos	malignant_62
CTGTCGTAGCGATCGA-1_pos	malignant_62
GAGGCAAAGTTGCGAG-1_pos	malignant_62
GAGTCATTCAAGCCTA-1_pos	malignant_62
GATGTTGTCGTAGTCA-1_pos	malignant_62
GCCAACGTCCGAGTGC-1_pos	malignant_62
GCGTGCAAGGCTTTCA-1_pos	malignant_62
GGGCTACGTGGAACAC-1_pos	malignant_62
GTAATCGAGTTCTACG-1_pos	malignant_62
GTAGAGGCACACGGAA-1_pos	malignant_62
GTCTTTACAACTCATG-1_pos	malignant_62
GTGCAGCGTCCGGACT-1_pos	malignant_62
GTTAGTGTCTTCACGC-1_pos	malignant_62
TACAGGTTCGAGAAGC-1_pos	malignant_62
TACCTCGCAAGTTCGT-1_pos	malignant_62
TACGTCCGTCAACCAT-1_pos	malignant_62
TAGGAGGGTGTTCGTA-1_pos	malignant_62
TAGGAGGTCACCTGTC-1_pos	malignant_62
TCGTGGGAGAGGACTC-1_pos	malignant_62
TGCATGATCTCTCAAT-1_pos	malignant_62
TGCCGAGCAAGAGCTG-1_pos	malignant_62
TTCCTCTTCGAATCCA-1_pos	malignant_62
TTGGGCGCATGGACAG-1_pos	malignant_62
TTTAGTCGTGGACTAG-1_pos	malignant_62
AAGTACCGTATTAAGG-1_pos	malignant_65
AGTACTGCATAATCGC-1_pos	malignant_65
ATAGACCAGTATTAGG-1_pos	malignant_65
ATCGGCGGTCATACCA-1_pos	malignant_65
ATCTTCATCAGCAGAG-1_pos	malignant_65
CCTATCGCATGCTGCG-1_pos	malignant_65
CTGCTCATCCTCTAGC-1_pos	malignant_65
CTTCCTTAGAAAGCGA-1_pos	malignant_65
GACCGTGCATGTGCTA-1_pos	malignant_65
GACGCTGCAAGTGCAG-1_pos	malignant_65
GGACGTCTCTCGAACA-1_pos	malignant_65
GGGAAGTAGGTAACTA-1_pos	malignant_65
GTGCACGAGGAACTAT-1_pos	malignant_65
TAACCAGAGATTGCGG-1_pos	malignant_65
TACACCCAGGCATCGA-1_pos	malignant_65
TCATTACAGGATACAT-1_pos	malignant_65
TCCATCGCAACAACAA-1_pos	malignant_65
TGCTCCACAATAACGA-1_pos	malignant_65
TTAGGCAGTAACAGTA-1_pos	malignant_65
AAACGCTAGCCGTAAG-1_pos	malignant_78
ACTTCCGTCTGTGCAA-1_pos	malignant_78
AGACTCACAGTCTTCC-1_pos	malignant_78
AGATAGATCACACCCT-1_pos	malignant_78
CATCCCATCTAGAGCT-1_pos	malignant_78
CATCGTCAGGGCAAGG-1_pos	malignant_78
CCGTAGGAGCAACCAG-1_pos	malignant_78
GATGCTACATTCTCCG-1_pos	malignant_78
GGAACCCCAGGCTTGC-1_pos	malignant_78
GGAATGGGTAGTGGCA-1_pos	malignant_78
GTCACGGTCCTATTGT-1_pos	malignant_78
TACCCACTCAGCGCGT-1_pos	malignant_78
TACGGTAGTAGACTGG-1_pos	malignant_78
TGATTCTCACAGTCCG-1_pos	malignant_78
TGTACAGAGTGATCGG-1_pos	malignant_78
TTTACCAAGTATTCCG-1_pos	malignant_78
TTTACGTTCACGGTCG-1_pos	malignant_78
AAAGAACTCCTGGCTT-1_neg	normal
AAAGTCCGTACTAACC-1_neg	normal
AAAGTGAAGCTTCTAG-1_neg	normal
AACAACCGTCCATAGT-1_neg	normal
AACACACCAGCGTTGC-1_neg	normal
AACCAACCAGTCTGGC-1_neg	normal
AACCAACTCTTCGCTG-1_neg	normal
AACCATGCACAAATAG-1_neg	normal
AACCCAACAATTCTCT-1_neg	normal
AACCTTTCAGCTGTAT-1_neg	normal
AACCTTTTCTGTCCGT-1_neg	normal
AACGTCACATACTGAC-1_neg	normal
AACGTCAGTGATGTAA-1_neg	normal
AACTTCTCACCACATA-1_neg	normal
AAGAACATCGAACGGA-1_neg	normal
AAGACTCAGCCTATCA-1_neg	normal
AAGATAGTCCCAATAG-1_neg	normal
AAGCCATTCCCATTCG-1_neg	normal
AAGCGAGGTTGCATCA-1_neg	normal
AAGTACCTCACGATAC-1_neg	normal
AAGTCGTAGCTCCACG-1_neg	normal
AAGTGAAAGGTCCGAA-1_neg	normal
AAGTTCGTCCCAACTC-1_neg	normal
AATAGAGAGAATTTGG-1_neg	normal
AATAGAGAGTACAGAT-1_neg	normal
AATAGAGCAACAACAA-1_neg	normal
AATAGAGGTTTCCCAC-1_neg	normal
AATCGTGTCCAACTGA-1_neg	normal
AATGACCAGTGCGACA-1_neg	normal
AATGGCTCAATGTCAC-1_neg	normal
AATTTCCTCTTAGCCC-1_neg	normal
ACAACCATCAAGAGGC-1_neg	normal
ACACAGTTCTCATTGT-1_neg	normal
ACACTGAGTGCATTTG-1_neg	normal
ACACTGATCTTAGCAG-1_neg	normal
ACATCGAGTACTCGAT-1_neg	normal
ACATCGATCCTATTGT-1_neg	normal
ACATCGATCGTTCTAT-1_neg	normal
ACATGCAAGTGGCGAT-1_neg	normal
ACATTTCGTTATCCAG-1_neg	normal
ACATTTCTCAACTACG-1_neg	normal
ACATTTCTCCACAGCG-1_neg	normal
ACCAAACGTCTTGAAC-1_neg	normal
ACCATTTGTTAGAAAC-1_neg	normal
ACCCTCATCTATTTCG-1_neg	normal
ACCCTTGAGATTGTGA-1_neg	normal
ACCCTTGCACTTGAGT-1_neg	normal
ACCGTTCCACATGAAA-1_neg	normal
ACGATCAAGGGTACGT-1_neg	normal
ACGATCAAGTGACCTT-1_neg	normal
ACGGTTAGTTGTGCCG-1_neg	normal
ACGTAACCAGCATCTA-1_neg	normal
ACGTACATCGGCTGAC-1_neg	normal
ACTATCTCAATACCCA-1_neg	normal
ACTATGGAGACCAGCA-1_neg	normal
ACTATGGAGCTCGTGC-1_neg	normal
ACTATTCGTTGCCGCA-1_neg	normal
ACTGATGAGTTGTCAC-1_neg	normal
ACTGATGTCTTGTGCC-1_neg	normal
ACTGCAATCTGGGAGA-1_neg	normal
ACTGTCCGTGTCGCTG-1_neg	normal
ACTGTGATCTCGGCTT-1_neg	normal
ACTTAGGAGTACTCGT-1_neg	normal
ACTTATCCAATAGTGA-1_neg	normal
ACTTATCGTCTCGACG-1_neg	normal
ACTTCGCTCGCCAGAC-1_neg	normal
ACTTTCAGTACAACGG-1_neg	normal
ACTTTCATCGAGATAA-1_neg	normal
AGAAGCGAGGTTCAGG-1_neg	normal
AGAAGCGCAACAAAGT-1_neg	normal
AGACCATGTGTCCAAT-1_neg	normal
AGACTCAGTTGTGCCG-1_neg	normal
AGAGAATGTTTGTTCT-1_neg	normal
AGAGAGCCATCTGCGG-1_neg	normal
AGAGAGCGTTGACTGT-1_neg	normal
AGAGCAGCAACAGCTT-1_neg	normal
AGATAGAAGCGATTCT-1_neg	normal
AGATAGAGTTGAGAGC-1_neg	normal
AGATCCACACTACGGC-1_neg	normal
AGATCGTAGACGAAGA-1_neg	normal
AGATGCTCACACGCCA-1_neg	normal
AGCCAATAGCTCCCTT-1_neg	normal
AGCCAATTCTGCGATA-1_neg	normal
AGCCACGGTGCAACGA-1_neg	normal
AGCCAGCAGCCGCACT-1_neg	normal
AGCCAGCCATGACTTG-1_neg	normal
AGCGATTAGAGATTCA-1_neg	normal
AGCGATTCAGATCCTA-1_neg	normal
AGCGTATAGTTCATCG-1_neg	normal
AGCTACATCAAGCGTT-1_neg	normal
AGCTCAAAGCACTAGG-1_neg	normal
AGCTCAACACGGAAGT-1_neg	normal
AGGACGAAGAGAGCAA-1_neg	normal
AGGACGACAGGAGGAG-1_neg	normal
AGGACGATCAAGCCAT-1_neg	normal
AGGATAAAGTCTTCGA-1_neg	normal
AGGCCACTCAGGAGAC-1_neg	normal
AGGCTGCAGCCGATAG-1_neg	normal
AGGGCCTAGTAGGATT-1_neg	normal
AGGGCTCAGCTTTCTT-1_neg	normal
AGGGTCCAGGTAGATT-1_neg	normal
AGGGTCCGTGAATGAT-1_neg	normal
AGGGTCCTCTTACACT-1_neg	normal
AGGGTGACAAGTGATA-1_neg	normal
AGGTCTAAGCGCCATC-1_neg	normal
AGGTGTTAGCGCATCC-1_neg	normal
AGGTTACTCAGTGCGC-1_neg	normal
AGGTTGTAGACGGTTG-1_neg	normal
AGTAACCAGTCGGCCT-1_neg	normal
AGTAGTCAGTCCGCCA-1_neg	normal
AGTCACAAGAGGTTTA-1_neg	normal
AGTCACACACCCTAAA-1_neg	normal
AGTCACATCCTAGCTC-1_neg	normal
AGTGACTAGACTGTTC-1_neg	normal
AGTGTTGAGACCGCCT-1_neg	normal
AGTTCGACAATCTCGA-1_neg	normal
AGTTCGACAGGTGTTT-1_neg	normal
AGTTCGAGTCAAACGG-1_neg	normal
ATACCGATCTCGGTCT-1_neg	normal
ATACCTTTCTACGGGC-1_neg	normal
ATAGACCAGAAGTGTT-1_neg	normal
ATAGACCTCGGAGATG-1_neg	normal
ATAGAGACACTCTCGT-1_neg	normal
ATAGGCTAGCAGCCTC-1_neg	normal
ATAGGCTCAGATACTC-1_neg	normal
ATATCCTAGGGTCTTT-1_neg	normal
ATATCCTCACGCACCA-1_neg	normal
ATATCCTTCACCCATC-1_neg	normal
ATCACGAGTGCCGTAC-1_neg	normal
ATCAGGTTCAACACGT-1_neg	normal
ATCCCTGAGGCTCCCA-1_neg	normal
ATCCCTGCATACTGAC-1_neg	normal
ATCGATGTCGTAGTGT-1_neg	normal
ATCGGATGTACGTGAG-1_neg	normal
ATCGTGAAGACTCAAA-1_neg	normal
ATGAAAGAGCCGTAAG-1_neg	normal
ATGACCAGTCGCACAC-1_neg	normal
ATGAGGGGTAATGCGG-1_neg	normal
ATGAGTCAGCTATCTG-1_neg	normal
ATGCATGTCACTTCTA-1_neg	normal
ATGCGATCACTGGAAG-1_neg	normal
ATGCGATGTGCTGTCG-1_neg	normal
ATGCGATTCTGGACCG-1_neg	normal
ATGGGAGGTCGATTAC-1_neg	normal
ATGGGTTAGTGCCAGA-1_neg	normal
ATGGTTGTCTAGTTCT-1_neg	normal
ATTCACTGTGCATGTT-1_neg	normal
ATTCAGGCAGCGTACC-1_neg	normal
ATTCAGGTCCCACAGG-1_neg	normal
ATTCCCGTCACTCACC-1_neg	normal
ATTCCCGTCGTGCACG-1_neg	normal
ATTCCTAAGACCAACG-1_neg	normal
ATTCGTTCACAAGGTG-1_neg	normal
ATTCTACGTTAGGACG-1_neg	normal
ATTGTTCGTCTACACA-1_neg	normal
ATTTCTGGTGGTAACG-1_neg	normal
CAAAGAACAAAGAACT-1_neg	normal
CAACGGCTCTGTGCAA-1_neg	normal
CAATACGCAGTTGAAA-1_neg	normal
CAATACGCATAGACTC-1_neg	normal
CAATGACAGGCATTTC-1_neg	normal
CACAACAGTGAGCCAA-1_neg	normal
CACACAAGTACGATTC-1_neg	normal
CACAGGCAGTCGAAGC-1_neg	normal
CACCAAACAAGCTACT-1_neg	normal
CACGTGGAGCTTTCTT-1_neg	normal
CACGTGGGTAATTAGG-1_neg	normal
CACGTGGTCAGACTGT-1_neg	normal
CACGTGGTCTACGCAA-1_neg	normal
CACTGTCGTTCTGAGT-1_neg	normal
CACTTCGTCCTCACCA-1_neg	normal
CAGATTGGTTCGGCGT-1_neg	normal
CAGCAATGTGTTATCG-1_neg	normal
CAGCACGCAATGGGTG-1_neg	normal
CAGCAGCCAAACTAGA-1_neg	normal
CAGCGTGAGTACCATC-1_neg	normal
CAGCGTGGTCAGTCGC-1_neg	normal
CAGCGTGTCACTACGA-1_neg	normal
CAGGCCACAAGCGAGT-1_neg	normal
CAGGCCAGTCATCGGC-1_neg	normal
CAGGCCATCATCCTAT-1_neg	normal
CAGGGCTTCATTTGGG-1_neg	normal
CAGGTATGTCCCAAAT-1_neg	normal
CAGGTATTCCTTGAAG-1_neg	normal
CATAAGCAGGTCATAA-1_neg	normal
CATAAGCTCAAAGGTA-1_neg	normal
CATACCCCAAGTGCAG-1_neg	normal
CATACTTCATAATCCG-1_neg	normal
CATCAAGTCTCGCTTG-1_neg	normal
CATCCCACATAGGAGC-1_neg	normal
CATCCGTCAGGTACGA-1_neg	normal
CATCCGTTCTGAGAGG-1_neg	normal
CATCGCTAGTCGAATA-1_neg	normal
CATCGCTCAGACGCTC-1_neg	normal
CATCGGGCATTACTCT-1_neg	normal
CATCGGGTCAGCTTCC-1_neg	normal
CATCGGGTCCGTAATG-1_neg	normal
CATGCCTAGGCTTTCA-1_neg	normal
CATGCCTAGTATGTAG-1_neg	normal
CATGCGGTCGTGCATA-1_neg	normal
CATGCTCAGAGAGCAA-1_neg	normal
CATGGTAGTTGGCCTG-1_neg	normal
CATTCCGCACTACACA-1_neg	normal
CATTCCGGTGAGAGGG-1_neg	normal
CATTGCCAGCTTCGTA-1_neg	normal
CATTTCAGTCGTGGAA-1_neg	normal
CCAAGCGCAAATGCGG-1_neg	normal
CCAATTTAGGGCCAAT-1_neg	normal
CCAATTTCACCGTACG-1_neg	normal
CCACCATCACAGCCTG-1_neg	normal
CCACGAGGTCTGTGTA-1_neg	normal
CCACGAGTCAACTGGT-1_neg	normal
CCACTTGGTCCCACGA-1_neg	normal
CCATCACCAGGTCAGA-1_neg	normal
CCCATTGCATCGTGCG-1_neg	normal
CCCGGAATCGGCCAAC-1_neg	normal
CCCTCAAGTTGTACGT-1_neg	normal
CCGATCTTCAGCTTCC-1_neg	normal
CCGGACACAAGTGATA-1_neg	normal
CCGGGTACAGGACATG-1_neg	normal
CCGGGTAGTGTCCATA-1_neg	normal
CCGGTAGTCGGTAGGA-1_neg	normal
CCGGTGAAGTGATTCC-1_neg	normal
CCGTGAGAGGCACAAC-1_neg	normal
CCGTGAGCAGCCGGTT-1_neg	normal
CCGTGAGTCGGTATGT-1_neg	normal
CCGTGAGTCGTGCAGC-1_neg	normal
CCGTTCAGTCCTCCTA-1_neg	normal
CCTAAGACAATCCTAG-1_neg	normal
CCTAAGATCAACCTTT-1_neg	normal
CCTACGTCAAATACAG-1_neg	normal
CCTACGTTCCGTATAG-1_neg	normal
CCTATCGCATGGCTGC-1_neg	normal
CCTCTAGAGCCGGAAT-1_neg	normal
CCTCTCCTCCACTTCG-1_neg	normal
CCTGTTGGTGCTGTCG-1_neg	normal
CGAAGTTCACCGTCGA-1_neg	normal
CGAAGTTGTAACTAAG-1_neg	normal
CGAGGAACATGTTACG-1_neg	normal
CGATCGGTCGCAGATT-1_neg	normal
CGATGGCGTATCGAAA-1_neg	normal
CGCAGGTCAACAAGTA-1_neg	normal
CGCATAATCATACGGT-1_neg	normal
CGCATAATCCTCTAAT-1_neg	normal
CGCCATTAGCGACTGA-1_neg	normal
CGCCATTCATAGTCGT-1_neg	normal
CGCCATTTCGCTAATG-1_neg	normal
CGGAACCGTGTTACTG-1_neg	normal
CGGAACCTCCATTTAC-1_neg	normal
CGGCAGTCAGTCGGAA-1_neg	normal
CGGTCAGAGGGAGATA-1_neg	normal
CGGTCAGCATTGGCAT-1_neg	normal
CGGTCAGGTGGCTGAA-1_neg	normal
CGTAATGCAGAACGCA-1_neg	normal
CGTGAATAGATGCTTC-1_neg	normal
CGTGAATGTTTCGATG-1_neg	normal
CGTGATATCAGCCTCT-1_neg	normal
CTAACTTGTACTCCGG-1_neg	normal
CTACAGACATTGCAAC-1_neg	normal
CTACCTGTCAAGAAAC-1_neg	normal
CTACGGGAGTAGGATT-1_neg	normal
CTACGGGGTAGAGACC-1_neg	normal
CTACTATCAGTACTAC-1_neg	normal
CTACTATCATGACTGT-1_neg	normal
CTATAGGAGTGATAAC-1_neg	normal
CTATAGGGTTGAATCC-1_neg	normal
CTCAAGAGTGTTCATG-1_neg	normal
CTCAATTTCAGCCTTC-1_neg	normal
CTCAGAACAGAATCGG-1_neg	normal
CTCATCGGTTCGTAAC-1_neg	normal
CTCATGCCAGCATCTA-1_neg	normal
CTCATGCTCACTCGAA-1_neg	normal
CTCCAACGTCGGTACC-1_neg	normal
CTCCAACTCTAAGGAA-1_neg	normal
CTCCACAAGCTCCATA-1_neg	normal
CTCCATGAGATGGCAC-1_neg	normal
CTCCATGCAAACACGG-1_neg	normal
CTCCCTCGTCCAGCCA-1_neg	normal
CTCCGATTCATCGCTC-1_neg	normal
CTCCTTTAGCGACATG-1_neg	normal
CTCCTTTTCGAGTCCG-1_neg	normal
CTCTCAGTCATCGCCT-1_neg	normal
CTCTGGTAGGGCTAAC-1_neg	normal
CTGAATGCATCGGATT-1_neg	normal
CTGAGCGCATACGCAT-1_neg	normal
CTGAGCGGTTCTCTCG-1_neg	normal
CTGAGGCCAATGACCT-1_neg	normal
CTGAGGCCACAGCTTA-1_neg	normal
CTGATCCCAGGCTTGC-1_neg	normal
CTGCATCTCTTACACT-1_neg	normal
CTGCCATCAACACAGG-1_neg	normal
CTGCTCAAGTGCCCGT-1_neg	normal
CTGGCAGGTCAAATCC-1_neg	normal
CTGTACCCACATGAAA-1_neg	normal
CTGTACCCAGTGGGTA-1_neg	normal
CTGTGAAAGAGAGGGC-1_neg	normal
CTGTGAATCTTGGCTC-1_neg	normal
CTTAGGATCAAACCTG-1_neg	normal
CTTAGGATCCCTTGTG-1_neg	normal
CTTCAATGTGCACATT-1_neg	normal
CTTCGGTCAGTAACCT-1_neg	normal
CTTGAGATCGAACGCC-1_neg	normal
CTTGATTTCGTGTCAA-1_neg	normal
CTTTCAACAAGGATGC-1_neg	normal
CTTTCAAGTGGGTCAA-1_neg	normal
GAAACCTTCCGCAGTG-1_neg	normal
GAAATGAGTTTGAAAG-1_neg	normal
GAACACTAGACATGCG-1_neg	normal
GAAGAATCACCCTAGG-1_neg	normal
GAAGCCCAGGTCCTGC-1_neg	normal
GAAGCCCAGTTAGTGA-1_neg	normal
GAAGCCCGTAGCTTTG-1_neg	normal
GAAGCCCTCCCTTCCC-1_neg	normal
GAAGCGAAGCAGAAAG-1_neg	normal
GAAGGGTGTGAATGAT-1_neg	normal
GAATAGAGTCACGACC-1_neg	normal
GAATAGAGTTCTAAGC-1_neg	normal
GAATAGATCCTGTAGA-1_neg	normal
GAATCACGTATGCGGA-1_neg	normal
GAATCACTCGTGCACG-1_neg	normal
GAATCGTCAGCATCTA-1_neg	normal
GACCTTCTCGGTCAGC-1_neg	normal
GACTATGTCCAAGCAT-1_neg	normal
GACTCAAGTTCCCAAA-1_neg	normal
GACTGATTCATCGCAA-1_neg	normal
GAGAAATAGAGTCAAT-1_neg	normal
GAGACCCAGTGGAAGA-1_neg	normal
GAGACTTCAGGTCTCG-1_neg	normal
GAGACTTTCACCCATC-1_neg	normal
GAGATGGAGTACAACA-1_neg	normal
GAGCTGCCAGAGTTCT-1_neg	normal
GAGGCCTGTCTGTAAC-1_neg	normal
GAGGCCTGTGAGTAGC-1_neg	normal
GAGTCATTCACTTATC-1_neg	normal
GAGTTGTAGACCTCCG-1_neg	normal
GATAGAAAGTGGTTCT-1_neg	normal
GATAGCTTCCATTTGT-1_neg	normal
GATCATGAGGTAGACC-1_neg	normal
GATCATGAGGTCTACT-1_neg	normal
GATCATGGTAGGCTGA-1_neg	normal
GATCGTAAGATGGTAT-1_neg	normal
GATGGAGTCTGGGCGT-1_neg	normal
GATGTTGGTGGTCCCA-1_neg	normal
GATGTTGTCATCTATC-1_neg	normal
GATTCTTCAGAGAAAG-1_neg	normal
GATTCTTCATCGATAC-1_neg	normal
GATTCTTGTGGTCTTA-1_neg	normal
GATTCTTTCATCCTGC-1_neg	normal
GATTGGTAGGTTAAAC-1_neg	normal
GATTGGTTCCAATCCC-1_neg	normal
GATTTCTGTTGACGGA-1_neg	normal
GCAACATAGCGCAATG-1_neg	normal
GCAACCGAGAACGCGT-1_neg	normal
GCAACCGGTTTCGTTT-1_neg	normal
GCACGGTAGGAGCTGT-1_neg	normal
GCACGTGGTCGAGATG-1_neg	normal
GCATCTCAGCACGGAT-1_neg	normal
GCATGATAGTTCCGTA-1_neg	normal
GCATTAGTCATCTGTT-1_neg	normal
GCCAGCATCTCCCAAC-1_neg	normal
GCCATGGAGCTAGAGC-1_neg	normal
GCCATTCAGACTTCCA-1_neg	normal
GCCCAGAAGGTCATTC-1_neg	normal
GCCCGAATCCACCTGT-1_neg	normal
GCGATCGAGAGTTCGG-1_neg	normal
GCGGATCCAACACTAC-1_neg	normal
GCGTTTCCATGCACTA-1_neg	normal
GCTACAAAGACCTCAT-1_neg	normal
GCTACCTTCTCTCGCA-1_neg	normal
GCTCAAAAGACATAAC-1_neg	normal
GCTGGGTCACTGGACC-1_neg	normal
GCTTTCGAGTGCGTCC-1_neg	normal
GGAAGTGCACTGGCGT-1_neg	normal
GGAATCTTCTGTCGTC-1_neg	normal
GGAATGGCACCCTCTA-1_neg	normal
GGACGTCCAGAGTGTG-1_neg	normal
GGAGATGTCGTGAGAG-1_neg	normal
GGAGGATAGGTGGCTA-1_neg	normal
GGAGGATTCGAGATGG-1_neg	normal
GGCTGTGTCACATTGG-1_neg	normal
GGCTTGGCAGAGGGTT-1_neg	normal
GGCTTGGGTTGTTTGG-1_neg	normal
GGCTTTCCATTGAGGG-1_neg	normal
GGGACTCGTCGTCAGC-1_neg	normal
GGGAGTAGTAGAATGT-1_neg	normal
GGGATCCAGAAGGGAT-1_neg	normal
GGGATGAAGTTGTCAC-1_neg	normal
GGGCGTTGTCTACAGT-1_neg	normal
GGGCGTTGTGCCTAAT-1_neg	normal
GGGCTCAGTGACAGCA-1_neg	normal
GGGCTCATCGATACGT-1_neg	normal
GGGTCTGCAAATGATG-1_neg	normal
GGGTGTCCAAAGCGTG-1_neg	normal
GGGTTATCAGCCCACA-1_neg	normal
GGTAACTGTGACTATC-1_neg	normal
GGTAACTGTTCGAGCC-1_neg	normal
GGTAATCCATGAATAG-1_neg	normal
GGTAGAGCAACTTGGT-1_neg	normal
GGTAGAGTCACGTCCT-1_neg	normal
GGTAGAGTCTTGTTAC-1_neg	normal
GGTCTGGTCTGCCCTA-1_neg	normal
GGTGAAGTCGAACCTA-1_neg	normal
GGTGATTAGAGGTTTA-1_neg	normal
GGTGATTTCCAACCGG-1_neg	normal
GGTGGCTAGATCCAAA-1_neg	normal
GGTGGCTCACTGCTTC-1_neg	normal
GGTGGCTTCTTCACAT-1_neg	normal
GGTGTCGAGCGTACAG-1_neg	normal
GGTGTTAAGGCATCAG-1_neg	normal
GGTGTTATCGCAATTG-1_neg	normal
GGTTAACGTACTCCCT-1_neg	normal
GGTTGTACACGACGCT-1_neg	normal
GGTTGTATCTAGAACC-1_neg	normal
GTAACCAAGCCTCATA-1_neg	normal
GTAAGTCTCCCAACTC-1_neg	normal
GTAATCGTCCGATAGT-1_neg	normal
GTACAGTCATCCTTGC-1_neg	normal
GTAGAAATCGACACCG-1_neg	normal
GTAGCTATCACCATGA-1_neg	normal
GTAGGTTAGCAGCGAT-1_neg	normal
GTAGTACGTGTAACGG-1_neg	normal
GTATTGGGTTGGTGTT-1_neg	normal
GTATTTCGTTCAAGGG-1_neg	normal
GTCACGGAGGTAACTA-1_neg	normal
GTCACTCGTTATAGCC-1_neg	normal
GTCATGAAGCTCGCAC-1_neg	normal
GTCATGAAGGTTGTTC-1_neg	normal
GTCATGAGTGCTGCAC-1_neg	normal
GTCCCATTCCATATGG-1_neg	normal
GTCCTCAAGGTCACCC-1_neg	normal
GTCTACCAGTGAGCCA-1_neg	normal
GTCTAGAGTTGAGAGC-1_neg	normal
GTCTCACCAAGTCGTT-1_neg	normal
GTCTCACTCGGTGTTA-1_neg	normal
GTCTGTCTCTACGCAA-1_neg	normal
GTCTTTACAAACAGGC-1_neg	normal
GTCTTTATCCGTTGAA-1_neg	normal
GTGAGCCCACAGAGAC-1_neg	normal
GTGAGGAAGACGGAAA-1_neg	normal
GTGAGTTCAAGCGCTC-1_neg	normal
GTGAGTTCACTCTGCT-1_neg	normal
GTGAGTTCACTGAGTT-1_neg	normal
GTGATGTTCTAGGAAA-1_neg	normal
GTGCGTGTCGAAGCAG-1_neg	normal
GTGCGTGTCGATGCAT-1_neg	normal
GTGCTGGAGCATGTTC-1_neg	normal
GTGCTTCGTGGCTTAT-1_neg	normal
GTGTAACTCGGTTAGT-1_neg	normal
GTGTGGCGTGTCTTGA-1_neg	normal
GTGTTAGAGACTCATC-1_neg	normal
GTGTTAGCAACAAAGT-1_neg	normal
GTGTTAGGTGTGACCC-1_neg	normal
GTTACGAGTGCTGTCG-1_neg	normal
GTTACGAGTGTCTAAC-1_neg	normal
GTTACGATCCAAATGC-1_neg	normal
GTTAGACCAGGAGGAG-1_neg	normal
GTTCCGTGTACAGGTG-1_neg	normal
GTTCCGTGTCACAGAG-1_neg	normal
GTTGAACCACCCAATA-1_neg	normal
GTTGCGGAGCTGAAGC-1_neg	normal
GTTGCTCAGGATTTAG-1_neg	normal
GTTGCTCTCCTGTAAG-1_neg	normal
GTTGTAGGTGTGTTTG-1_neg	normal
GTTTACTAGCGTTCAT-1_neg	normal
GTTTACTAGCTGTGCC-1_neg	normal
GTTTGGAGTGAACGGT-1_neg	normal
TAACACGCATCCGTTC-1_neg	normal
TAACCAGGTCCAGCCA-1_neg	normal
TAACGACCACCCTATC-1_neg	normal
TAACGACGTATCGATC-1_neg	normal
TAAGTCGTCATTCGGA-1_neg	normal
TAATCTCAGAGAGTGA-1_neg	normal
TAATCTCAGCTAGTTC-1_neg	normal
TAATCTCGTAGTCCTA-1_neg	normal
TAATTCCCAACAACAA-1_neg	normal
TAATTCCGTCAGTTTG-1_neg	normal
TACAACGCAATAGTGA-1_neg	normal
TACAGGTGTTGGTGTT-1_neg	normal
TACCCGTTCGGATACT-1_neg	normal
TACCTCGCAATTGCCA-1_neg	normal
TACCTCGGTCTAATCG-1_neg	normal
TACCTGCCAATACCCA-1_neg	normal
TACGGGCGTTGCTCAA-1_neg	normal
TACGGTATCTGGTGGC-1_neg	normal
TACTGCCGTGGTTTAC-1_neg	normal
TAGACCAGTAGGCAGT-1_neg	normal
TAGATCGAGCTGAAAT-1_neg	normal
TAGGTACAGATACTGA-1_neg	normal
TAGGTTGGTAAGATCA-1_neg	normal
TAGTGCAAGAGCAAGA-1_neg	normal
TATATCCAGCTCGAAG-1_neg	normal
TATCAGGAGTTCACTG-1_neg	normal
TATCCTAAGTTGCGAG-1_neg	normal
TATCTGTCAATTGTGC-1_neg	normal
TATCTTGAGTGAACAT-1_neg	normal
TATTCCAAGACTAGAT-1_neg	normal
TATTTCGAGACTTCGT-1_neg	normal
TATTTCGTCTGTGCGG-1_neg	normal
TCAAGACGTGGTTCTA-1_neg	normal
TCAATCTAGGCTGAAC-1_neg	normal
TCAATCTCATCCCACT-1_neg	normal
TCAATCTGTGCAAGAC-1_neg	normal
TCACGGGTCATGAGGG-1_neg	normal
TCAGCAAGTTGGACCC-1_neg	normal
TCAGCCTAGACGTCGA-1_neg	normal
TCAGTCCCAGCTGAAG-1_neg	normal
TCAGTCCCATGTTTGG-1_neg	normal
TCAGTGACAATAGAGT-1_neg	normal
TCAGTGATCAAGAAAC-1_neg	normal
TCATATCTCAAGCCTA-1_neg	normal
TCATGAGTCATCTGTT-1_neg	normal
TCATGTTCACCTGATA-1_neg	normal
TCCAGAATCCTACAAG-1_neg	normal
TCCATCGTCCACGTCT-1_neg	normal
TCCCACATCACTGCTC-1_neg	normal
TCCGGGATCAAATGAG-1_neg	normal
TCCGTGTGTATGACAA-1_neg	normal
TCCGTGTTCTAAGAAG-1_neg	normal
TCCTAATCAGTCTGGC-1_neg	normal
TCCTGCATCTATCGTT-1_neg	normal
TCCTTTCTCAGTGTTG-1_neg	normal
TCGAACACACAAATCC-1_neg	normal
TCGACGGTCCTATGGA-1_neg	normal
TCGCAGGCATCACCAA-1_neg	normal
TCGCAGGTCCGTATGA-1_neg	normal
TCGGATAGTTCTATCT-1_neg	normal
TCGGGACGTTCAATCG-1_neg	normal
TCGGGCAGTCCTGTCT-1_neg	normal
TCGGGTGTCTCATTGT-1_neg	normal
TCGGTCTCAGCTTTCC-1_neg	normal
TCGTAGAGTATACGGG-1_neg	normal
TCGTGCTGTCTTACAG-1_neg	normal
TCGTGGGAGTTGGAAT-1_neg	normal
TCGTGGGCAGCAATTC-1_neg	normal
TCGTGGGGTCCTACGG-1_neg	normal
TCTACCGTCCGGCAAC-1_neg	normal
TCTATCATCAATCCGA-1_neg	normal
TCTCACGTCGTACCTC-1_neg	normal
TCTCAGCGTGAGAACC-1_neg	normal
TCTCCGAGTACTAACC-1_neg	normal
TCTGGCTGTAAGATTG-1_neg	normal
TCTGGCTGTGCTCTTC-1_neg	normal
TCTTGCGAGATTTGCC-1_neg	normal
TGAACGTTCCACGGAC-1_neg	normal
TGAATCGGTCAATCTG-1_neg	normal
TGACAGTGTATGTGTC-1_neg	normal
TGACAGTGTCCCGTGA-1_neg	normal
TGACCCTAGAACAAGG-1_neg	normal
TGACGCGCACTCATAG-1_neg	normal
TGACGCGTCACGGGCT-1_neg	normal
TGACTCCTCCATGATG-1_neg	normal
TGAGCATAGAAGGCTC-1_neg	normal
TGAGCATCAATGTGGG-1_neg	normal
TGAGCGCTCATTGTTC-1_neg	normal
TGAGGAGAGTTGTAAG-1_neg	normal
TGAGGAGTCTGGGCCA-1_neg	normal
TGAGGGAGTGAATTGA-1_neg	normal
TGAGGGAGTTATAGAG-1_neg	normal
TGAGGGATCTTCCGTG-1_neg	normal
TGAGGTTCAATAAGGT-1_neg	normal
TGAGGTTTCTAGTTCT-1_neg	normal
TGAGTCACAATGGGTG-1_neg	normal
TGATGGTCACCACATA-1_neg	normal
TGATGGTGTCAAGCGA-1_neg	normal
TGCAGTAGTGAGATCG-1_neg	normal
TGCATCCAGGAACATT-1_neg	normal
TGCCGAGCATCGTTCC-1_neg	normal
TGCGATATCTCTGCCA-1_neg	normal
TGGAGGACAACCGTAT-1_neg	normal
TGGGAGACATGACGAG-1_neg	normal
TGGGATTAGGAGACCT-1_neg	normal
TGGGATTGTAATCAGA-1_neg	normal
TGGGCTGAGTTCGGTT-1_neg	normal
TGGTACACAATACGCT-1_neg	normal
TGGTAGTCAACAAGAT-1_neg	normal
TGGTAGTGTATTCTCT-1_neg	normal
TGGTGATAGAGAGCCT-1_neg	normal
TGTACAGGTCTTCTAT-1_neg	normal
TGTAGACTCCCAGGCA-1_neg	normal
TGTGAGTTCATCTCTA-1_neg	normal
TGTGCGGCACATGGTT-1_neg	normal
TGTGCGGTCGATTCCC-1_neg	normal
TGTGGCGGTTCAAACC-1_neg	normal
TGTTCCGAGTCAACAA-1_neg	normal
TGTTGAGTCAAACGTC-1_neg	normal
TGTTGGAAGAGTGAAG-1_neg	normal
TGTTGGATCCGTGGGT-1_neg	normal
TGTTTGTAGCTGCCTG-1_neg	normal
TTAATCCGTTGATGTC-1_neg	normal
TTACAGGCACGGGCTT-1_neg	normal
TTACAGGGTGCAATGG-1_neg	normal
TTACCATAGGCTAGCA-1_neg	normal
TTACCGCCAAGGTCGA-1_neg	normal
TTACGCCAGCACACAG-1_neg	normal
TTACTGTGTATCCCTC-1_neg	normal
TTAGGCAGTATCAAGA-1_neg	normal
TTAGGGTGTAACATAG-1_neg	normal
TTAGTCTAGCGTACAG-1_neg	normal
TTATTGCAGGTTGGTG-1_neg	normal
TTATTGCTCGAGCCTG-1_neg	normal
TTCAATCCAGTTCTAG-1_neg	normal
TTCACGCGTGTCCTAA-1_neg	normal
TTCCAATTCGTCTAAG-1_neg	normal
TTCCAATTCTTTACAC-1_neg	normal
TTCCGGTTCCATCTCG-1_neg	normal
TTCGCTGCATTACGGT-1_neg	normal
TTCGGTCCAGCTTTGA-1_neg	normal
TTCTAGTGTTTCACAG-1_neg	normal
TTCTGTACAACGGTAG-1_neg	normal
TTCTTGAGTTCTAACG-1_neg	normal
TTGAGTGAGCTTAGTC-1_neg	normal
TTGAGTGGTTTGGGTT-1_neg	normal
TTGCATTAGAACGTGC-1_neg	normal
TTGCATTCACTCTCGT-1_neg	normal
TTGCCTGGTCATAAAG-1_neg	normal
TTGCTGCAGGTCACAG-1_neg	normal
TTGCTGCGTAGTCCTA-1_neg	normal
TTGGATGCAGGCACAA-1_neg	normal
TTGGGATGTTGCAACT-1_neg	normal
TTGGGCGAGTATGGAT-1_neg	normal
TTGTTGTTCCCGAGGT-1_neg	normal
TTGTTGTTCCGTTGGG-1_neg	normal
TTTACGTAGGTACAAT-1_neg	normal
TTTACGTTCCTCACCA-1_neg	normal
TTTCACAGTCAGTCGC-1_neg	normal
TTTCACATCCTGTAAG-1_neg	normal
TTTCATGCATATCGGT-1_neg	normal
TTTCGATGTACCTAAC-1_neg	normal
TTTGACTAGGTTGTTC-1_neg	normal
TTTGATCCACAGTATC-1_neg	normal
TTTGGTTAGTCATACC-1_neg	normal
TTTGGTTCACAAGGTG-1_neg	normal
TTTGGTTGTCAACCAT-1_neg	normal
TTTGTTGCAATTTCGG-1_neg	normal
TTTGTTGCATTGCTTT-1_neg	normal
